Average Trip Duration,Amount of Rides,Subscribers,Non Subscribers,Subscriber %,Non Subscriber %
13.882352941176471,17,8,9,47.0,53.0
15.4,20,11,9,55.0,45.0
17.0,5,3,2,60.0,40.0
32.0,1,1,0,100.0,0.0
14.5,2,2,0,100.0,0.0
40.666666666666664,3,3,0,100.0,0.0
13.25,8,5,3,62.0,38.0
44.0,11,6,5,55.0,45.0
23.77777777777778,9,5,4,56.0,44.0
43.05,20,11,9,55.0,45.0
25.0,17,11,6,65.0,35.0
32.38235294117647,34,11,23,32.0,68.0
31.853658536585368,41,17,24,41.0,59.0
24.133333333333333,45,21,24,47.0,53.0
22.9,30,14,16,47.0,53.0
7.052631578947368,19,16,3,84.0,16.0
19.7,10,10,0,100.0,0.0
17.25,8,6,2,75.0,25.0
13.777777777777779,9,4,5,44.0,56.0
19.0,1,1,0,100.0,0.0
5.666666666666667,3,3,0,100.0,0.0
31.0,3,3,0,100.0,0.0
7.0,1,1,0,100.0,0.0
2.0,1,1,0,100.0,0.0
35.0,7,6,1,86.0,14.0
4.0,7,6,1,86.0,14.0
8.157894736842104,19,17,2,89.0,11.0
11.821428571428571,28,25,3,89.0,11.0
13.652173913043478,23,21,2,91.0,9.0
28.142857142857142,14,11,3,79.0,21.0
16.157894736842106,19,15,4,79.0,21.0
18.862068965517242,29,19,10,66.0,34.0
14.954545454545455,22,17,5,77.0,23.0
20.25,24,13,11,54.0,46.0
17.666666666666668,18,12,6,67.0,33.0
14.233333333333333,30,21,9,70.0,30.0
10.551724137931034,29,25,4,86.0,14.0
17.444444444444443,18,18,0,100.0,0.0
10.857142857142858,14,13,1,93.0,7.0
14.7,10,9,1,90.0,10.0
19.636363636363637,11,7,4,64.0,36.0
3.5714285714285716,7,7,0,100.0,0.0
21.5,2,2,0,100.0,0.0
15.166666666666666,6,5,1,83.0,17.0
27.0,5,5,0,100.0,0.0
3.0,1,1,0,100.0,0.0
9.0,3,3,0,100.0,0.0
8.5,4,4,0,100.0,0.0
6.875,8,7,1,88.0,12.0
11.31578947368421,19,18,1,95.0,5.0
11.743589743589743,39,35,4,90.0,10.0
14.68421052631579,19,15,4,79.0,21.0
26.058823529411764,17,9,8,53.0,47.0
20.92,25,18,7,72.0,28.0
34.65384615384615,26,13,13,50.0,50.0
33.578947368421055,19,11,8,58.0,42.0
23.34285714285714,35,21,14,60.0,40.0
32.75,28,18,10,64.0,36.0
12.837837837837839,37,27,10,73.0,27.0
13.81081081081081,37,30,7,81.0,19.0
19.541666666666668,24,18,6,75.0,25.0
12.0,12,8,4,67.0,33.0
24.5,8,4,4,50.0,50.0
20.0,13,6,7,46.0,54.0
21.2,5,5,0,100.0,0.0
16.333333333333332,6,5,1,83.0,17.0
7.2,5,4,1,80.0,20.0
15.0,5,5,0,100.0,0.0
43.5,2,2,0,100.0,0.0
10.0,1,1,0,100.0,0.0
4.0,1,1,0,100.0,0.0
8.0,2,2,0,100.0,0.0
23.0,8,7,1,88.0,12.0
10.823529411764707,17,16,1,94.0,6.0
8.543478260869565,46,41,5,89.0,11.0
10.384615384615385,26,23,3,88.0,12.0
20.153846153846153,13,12,1,92.0,8.0
19.863636363636363,22,17,5,77.0,23.0
12.789473684210526,19,15,4,79.0,21.0
25.96551724137931,29,20,9,69.0,31.0
27.11764705882353,34,21,13,62.0,38.0
36.588235294117645,17,14,3,82.0,18.0
13.238095238095237,21,17,4,81.0,19.0
10.461538461538462,26,26,0,100.0,0.0
11.193548387096774,31,30,1,97.0,3.0
12.0,10,10,0,100.0,0.0
11.6,10,8,2,80.0,20.0
6.75,4,4,0,100.0,0.0
6.5,4,4,0,100.0,0.0
21.25,4,4,0,100.0,0.0
6.666666666666667,3,2,1,67.0,33.0
59.5,2,2,0,100.0,0.0
2.0,1,1,0,100.0,0.0
6.333333333333333,9,7,2,78.0,22.0
13.352941176470589,17,16,1,94.0,6.0
13.142857142857142,21,21,0,100.0,0.0
7.8125,16,13,3,81.0,19.0
27.0,16,15,1,94.0,6.0
16.923076923076923,13,12,1,92.0,8.0
12.428571428571429,14,13,1,93.0,7.0
21.857142857142858,21,12,9,57.0,43.0
26.192307692307693,26,16,10,62.0,38.0
25.205128205128204,39,22,17,56.0,44.0
24.6,35,24,11,69.0,31.0
14.659574468085106,47,40,7,85.0,15.0
14.272727272727273,22,17,5,77.0,23.0
19.384615384615383,13,12,1,92.0,8.0
21.615384615384617,13,9,4,69.0,31.0
32.75,8,7,1,88.0,12.0
23.5,2,2,0,100.0,0.0
23.166666666666668,6,6,0,100.0,0.0
19.0,1,1,0,100.0,0.0
19.166666666666668,6,5,1,83.0,17.0
33.5,2,2,0,100.0,0.0
18.0,2,2,0,100.0,0.0
17.0,1,1,0,100.0,0.0
4.333333333333333,3,3,0,100.0,0.0
6.333333333333333,3,3,0,100.0,0.0
19.714285714285715,14,13,1,93.0,7.0
20.0,23,15,8,65.0,35.0
23.357142857142858,14,12,2,86.0,14.0
19.58823529411765,34,25,9,74.0,26.0
29.25925925925926,27,17,10,63.0,37.0
31.5,38,21,17,55.0,45.0
23.547619047619047,42,26,16,62.0,38.0
24.170731707317074,41,16,25,39.0,61.0
16.357142857142858,28,15,13,54.0,46.0
11.03225806451613,31,17,14,55.0,45.0
19.555555555555557,18,8,10,44.0,56.0
6.3,10,5,5,50.0,50.0
13.23076923076923,13,5,8,38.0,62.0
22.9,10,6,4,60.0,40.0
19.333333333333332,9,2,7,22.0,78.0
84.33333333333333,3,1,2,33.0,67.0
26.666666666666668,3,3,0,100.0,0.0
18.0,2,1,1,50.0,50.0
13.5,2,0,2,0.0,100.0
26.0,1,0,1,0.0,100.0
8.0,4,2,2,50.0,50.0
4.0,1,1,0,100.0,0.0
5.666666666666667,6,6,0,100.0,0.0
18.923076923076923,13,11,2,85.0,15.0
8.88888888888889,9,9,0,100.0,0.0
14.555555555555555,9,9,0,100.0,0.0
15.6,15,10,5,67.0,33.0
25.2,20,6,14,30.0,70.0
14.31578947368421,19,13,6,68.0,32.0
27.29032258064516,31,16,15,52.0,48.0
14.764705882352942,17,13,4,76.0,24.0
15.6,10,10,0,100.0,0.0
5.0,9,9,0,100.0,0.0
8.2,5,4,1,80.0,20.0
14.714285714285714,7,7,0,100.0,0.0
7.666666666666667,3,3,0,100.0,0.0
11.2,5,5,0,100.0,0.0
17.714285714285715,7,6,1,86.0,14.0
10.0,1,1,0,100.0,0.0
50.0,1,1,0,100.0,0.0
14.0,1,1,0,100.0,0.0
6.75,4,4,0,100.0,0.0
7.8,5,3,2,60.0,40.0
10.958333333333334,24,22,2,92.0,8.0
12.24390243902439,41,38,3,93.0,7.0
13.04,25,23,2,92.0,8.0
19.40909090909091,22,18,4,82.0,18.0
17.25,28,23,5,82.0,18.0
21.4,25,21,4,84.0,16.0
25.041666666666668,24,17,7,71.0,29.0
43.69565217391305,23,13,10,57.0,43.0
16.233333333333334,30,18,12,60.0,40.0
9.333333333333334,24,17,7,71.0,29.0
37.88095238095238,42,37,5,88.0,12.0
8.586206896551724,29,26,3,90.0,10.0
8.916666666666666,12,10,2,83.0,17.0
5.636363636363637,11,11,0,100.0,0.0
20.90909090909091,11,10,1,91.0,9.0
4.714285714285714,7,6,1,86.0,14.0
10.9,10,7,3,70.0,30.0
47.0,2,2,0,100.0,0.0
8.0,1,1,0,100.0,0.0
30.0,1,1,0,100.0,0.0
7.0,1,1,0,100.0,0.0
10.444444444444445,9,9,0,100.0,0.0
9.7,20,18,2,90.0,10.0
11.71875,32,30,2,94.0,6.0
13.777777777777779,18,18,0,100.0,0.0
27.555555555555557,9,7,2,78.0,22.0
21.272727272727273,11,11,0,100.0,0.0
9.571428571428571,14,10,4,71.0,29.0
87.33333333333333,15,12,3,80.0,20.0
12.714285714285714,7,5,2,71.0,29.0
14.708333333333334,24,22,2,92.0,8.0
17.870967741935484,31,27,4,87.0,13.0
9.65,40,38,2,95.0,5.0
16.53125,32,20,12,62.0,38.0
21.210526315789473,19,17,2,89.0,11.0
23.666666666666668,12,12,0,100.0,0.0
26.53846153846154,13,8,5,62.0,38.0
13.777777777777779,9,6,3,67.0,33.0
11.0,4,4,0,100.0,0.0
6.928571428571429,14,8,6,57.0,43.0
13.375,8,3,5,38.0,62.0
9.0,2,2,0,100.0,0.0
13.5,2,0,2,0.0,100.0
1.0,1,0,1,0.0,100.0
15.75,4,4,0,100.0,0.0
8.25,8,7,1,88.0,12.0
12.045454545454545,22,19,3,86.0,14.0
12.425,40,40,0,100.0,0.0
15.277777777777779,18,16,2,89.0,11.0
36.36363636363637,11,6,5,55.0,45.0
14.476190476190476,21,19,2,90.0,10.0
12.862068965517242,29,23,6,79.0,21.0
30.16,25,18,7,72.0,28.0
35.95652173913044,23,18,5,78.0,22.0
13.043478260869565,23,22,1,96.0,4.0
15.057142857142857,35,33,2,94.0,6.0
14.170731707317072,41,32,9,78.0,22.0
11.181818181818182,22,19,3,86.0,14.0
6.3076923076923075,13,12,1,92.0,8.0
20.875,8,7,1,88.0,12.0
11.0,8,7,1,88.0,12.0
21.833333333333332,12,8,4,67.0,33.0
12.0,4,4,0,100.0,0.0
11.8,5,5,0,100.0,0.0
8.0,1,1,0,100.0,0.0
20.333333333333332,3,2,1,67.0,33.0
8.0,1,1,0,100.0,0.0
9.8,5,5,0,100.0,0.0
8.333333333333334,6,6,0,100.0,0.0
11.619047619047619,21,18,3,86.0,14.0
10.68,25,24,1,96.0,4.0
30.2,15,15,0,100.0,0.0
34.666666666666664,6,6,0,100.0,0.0
41.36363636363637,11,6,5,55.0,45.0
12.0,9,9,0,100.0,0.0
37.22727272727273,22,14,8,64.0,36.0
30.666666666666668,9,6,3,67.0,33.0
102.0,13,10,3,77.0,23.0
14.333333333333334,12,9,3,75.0,25.0
11.653846153846153,26,25,1,96.0,4.0
12.73913043478261,23,22,1,96.0,4.0
11.1,20,15,5,75.0,25.0
13.214285714285714,14,13,1,93.0,7.0
23.09090909090909,11,10,1,91.0,9.0
14.555555555555555,9,8,1,89.0,11.0
10.333333333333334,3,3,0,100.0,0.0
26.666666666666668,6,6,0,100.0,0.0
25.75,4,1,3,25.0,75.0
27.0,2,1,1,50.0,50.0
8.0,1,1,0,100.0,0.0
7.0,2,2,0,100.0,0.0
14.25,4,4,0,100.0,0.0
9.884615384615385,26,23,3,88.0,12.0
10.971428571428572,35,31,4,89.0,11.0
12.68421052631579,19,18,1,95.0,5.0
8.2,15,14,1,93.0,7.0
9.576923076923077,26,23,3,88.0,12.0
14.538461538461538,26,19,7,73.0,27.0
25.1875,32,26,6,81.0,19.0
15.217391304347826,23,18,5,78.0,22.0
13.393939393939394,33,22,11,67.0,33.0
12.196078431372548,51,41,10,80.0,20.0
22.11111111111111,54,41,13,76.0,24.0
11.35483870967742,31,25,6,81.0,19.0
20.5,26,12,14,46.0,54.0
23.764705882352942,17,10,7,59.0,41.0
33.7,30,13,17,43.0,57.0
18.705882352941178,17,11,6,65.0,35.0
22.272727272727273,11,5,6,45.0,55.0
25.583333333333332,12,9,3,75.0,25.0
23.384615384615383,13,10,3,77.0,23.0
11.2,5,3,2,60.0,40.0
15.0,2,2,0,100.0,0.0
35.0,1,0,1,0.0,100.0
22.0,1,1,0,100.0,0.0
10.0,3,3,0,100.0,0.0
35.166666666666664,6,6,0,100.0,0.0
20.0,18,15,3,83.0,17.0
10.571428571428571,14,8,6,57.0,43.0
23.40625,32,17,15,53.0,47.0
34.25,52,33,19,63.0,37.0
31.317073170731707,82,32,50,39.0,61.0
30.0,89,33,56,37.0,63.0
48.701298701298704,77,26,51,34.0,66.0
30.973684210526315,76,29,47,38.0,62.0
35.67088607594937,79,27,52,34.0,66.0
24.418181818181818,55,23,32,42.0,58.0
22.25925925925926,27,14,13,52.0,48.0
26.419354838709676,31,12,19,39.0,61.0
32.6,25,10,15,40.0,60.0
26.74074074074074,27,16,11,59.0,41.0
15.052631578947368,19,13,6,68.0,32.0
9.6875,16,14,2,88.0,12.0
9.5,6,4,2,67.0,33.0
29.375,8,7,1,88.0,12.0
23.8,5,2,3,40.0,60.0
51.5,2,0,2,0.0,100.0
31.666666666666668,3,2,1,67.0,33.0
3.0,1,1,0,100.0,0.0
28.0,2,2,0,100.0,0.0
12.25,4,4,0,100.0,0.0
19.055555555555557,18,16,2,89.0,11.0
14.944444444444445,18,12,6,67.0,33.0
20.175,40,22,18,55.0,45.0
37.589285714285715,56,22,34,39.0,61.0
43.88636363636363,88,24,64,27.0,73.0
45.77884615384615,104,34,70,33.0,67.0
35.16483516483517,91,24,67,26.0,74.0
38.71052631578947,114,35,79,31.0,69.0
20.8,60,28,32,47.0,53.0
16.58,50,27,23,54.0,46.0
12.4,15,7,8,47.0,53.0
14.083333333333334,12,9,3,75.0,25.0
30.88888888888889,18,5,13,28.0,72.0
23.789473684210527,19,7,12,37.0,63.0
19.857142857142858,14,6,8,43.0,57.0
29.0,11,2,9,18.0,82.0
18.714285714285715,7,3,4,43.0,57.0
12.833333333333334,6,6,0,100.0,0.0
22.0,1,0,1,0.0,100.0
15.0,1,1,0,100.0,0.0
4.0,1,1,0,100.0,0.0
8.666666666666666,6,6,0,100.0,0.0
9.411764705882353,17,15,2,88.0,12.0
10.703703703703704,27,23,4,85.0,15.0
17.714285714285715,21,16,5,76.0,24.0
16.944444444444443,18,13,5,72.0,28.0
29.64,50,29,21,58.0,42.0
37.56,50,25,25,50.0,50.0
20.441860465116278,43,30,13,70.0,30.0
34.79032258064516,62,30,32,48.0,52.0
26.94736842105263,38,26,12,68.0,32.0
14.818181818181818,22,20,2,91.0,9.0
10.758620689655173,29,26,3,90.0,10.0
19.473684210526315,19,16,3,84.0,16.0
12.375,16,11,5,69.0,31.0
100.63636363636364,11,7,4,64.0,36.0
13.0,3,1,2,33.0,67.0
25.2,5,5,0,100.0,0.0
11.5,4,4,0,100.0,0.0
17.333333333333332,6,5,1,83.0,17.0
9.5,8,5,3,62.0,38.0
100.0,1,1,0,100.0,0.0
6.0,1,1,0,100.0,0.0
5.4,5,5,0,100.0,0.0
8.555555555555555,9,9,0,100.0,0.0
15.037037037037036,27,27,0,100.0,0.0
11.205128205128204,39,35,4,90.0,10.0
11.875,24,18,6,75.0,25.0
23.6,25,13,12,52.0,48.0
10.55,20,18,2,90.0,10.0
26.93548387096774,31,25,6,81.0,19.0
18.52777777777778,36,23,13,64.0,36.0
13.137931034482758,29,27,2,93.0,7.0
17.710526315789473,38,25,13,66.0,34.0
21.087719298245613,57,35,22,61.0,39.0
13.459016393442623,61,55,6,90.0,10.0
12.933333333333334,45,41,4,91.0,9.0
12.68421052631579,19,15,4,79.0,21.0
41.5,16,10,6,62.0,38.0
11.95,20,18,2,90.0,10.0
7.0,7,7,0,100.0,0.0
32.42857142857143,7,7,0,100.0,0.0
11.285714285714286,7,1,6,14.0,86.0
7.75,4,4,0,100.0,0.0
6.0,1,1,0,100.0,0.0
37.0,2,1,1,50.0,50.0
15.0,2,1,1,50.0,50.0
12.833333333333334,6,4,2,67.0,33.0
7.181818181818182,11,11,0,100.0,0.0
11.275862068965518,29,27,2,93.0,7.0
10.01923076923077,52,47,5,90.0,10.0
14.225806451612904,31,29,2,94.0,6.0
11.833333333333334,18,15,3,83.0,17.0
18.263157894736842,38,35,3,92.0,8.0
24.0,28,23,5,82.0,18.0
31.466666666666665,30,21,9,70.0,30.0
27.128205128205128,39,29,10,74.0,26.0
12.3,20,14,6,70.0,30.0
11.458333333333334,24,21,3,88.0,12.0
16.5,34,25,9,74.0,26.0
11.0,8,8,0,100.0,0.0
24.428571428571427,14,10,4,71.0,29.0
23.692307692307693,13,12,1,92.0,8.0
6.875,8,8,0,100.0,0.0
14.6,10,8,2,80.0,20.0
13.0,5,4,1,80.0,20.0
3.5,2,1,1,50.0,50.0
7.0,2,2,0,100.0,0.0
27.0,1,1,0,100.0,0.0
3.0,1,1,0,100.0,0.0
7.5,2,2,0,100.0,0.0
9.833333333333334,6,4,2,67.0,33.0
8.454545454545455,22,20,2,91.0,9.0
10.76086956521739,46,40,6,87.0,13.0
6.84,25,23,2,92.0,8.0
13.571428571428571,14,12,2,86.0,14.0
12.90625,32,29,3,91.0,9.0
15.777777777777779,18,16,2,89.0,11.0
11.428571428571429,14,11,3,79.0,21.0
14.857142857142858,7,6,1,86.0,14.0
7.8,10,10,0,100.0,0.0
12.894736842105264,38,36,2,95.0,5.0
11.041666666666666,48,44,4,92.0,8.0
11.538461538461538,26,24,2,92.0,8.0
10.538461538461538,13,13,0,100.0,0.0
18.466666666666665,15,14,1,93.0,7.0
14.454545454545455,11,11,0,100.0,0.0
11.2,5,5,0,100.0,0.0
19.4,5,5,0,100.0,0.0
12.0,1,1,0,100.0,0.0
4.75,4,3,1,75.0,25.0
18.333333333333332,3,2,1,67.0,33.0
10.0,1,1,0,100.0,0.0
5.0,1,1,0,100.0,0.0
10.0,10,10,0,100.0,0.0
22.047619047619047,21,18,3,86.0,14.0
11.193548387096774,31,28,3,90.0,10.0
14.541666666666666,24,22,2,92.0,8.0
11.666666666666666,12,10,2,83.0,17.0
16.4,30,24,6,80.0,20.0
17.862068965517242,29,25,4,86.0,14.0
12.89655172413793,29,24,5,83.0,17.0
32.7037037037037,27,20,7,74.0,26.0
16.043478260869566,23,13,10,57.0,43.0
23.483870967741936,31,21,10,68.0,32.0
14.72549019607843,51,41,10,80.0,20.0
14.272727272727273,33,30,3,91.0,9.0
11.428571428571429,14,14,0,100.0,0.0
10.444444444444445,18,14,4,78.0,22.0
11.11111111111111,9,8,1,89.0,11.0
13.0,4,3,1,75.0,25.0
15.857142857142858,7,6,1,86.0,14.0
4.571428571428571,7,7,0,100.0,0.0
19.833333333333332,6,4,2,67.0,33.0
20.5,4,4,0,100.0,0.0
432.0,2,2,0,100.0,0.0
18.0,1,1,0,100.0,0.0
4.0,1,1,0,100.0,0.0
8.571428571428571,14,14,0,100.0,0.0
21.75,16,9,7,56.0,44.0
18.28,25,19,6,76.0,24.0
19.7,30,22,8,73.0,27.0
20.258064516129032,31,19,12,61.0,39.0
23.394736842105264,38,22,16,58.0,42.0
22.128205128205128,39,17,22,44.0,56.0
22.0,48,25,23,52.0,48.0
20.666666666666668,36,18,18,50.0,50.0
14.16,25,13,12,52.0,48.0
14.16,25,13,12,52.0,48.0
13.875,8,5,3,62.0,38.0
15.222222222222221,18,11,7,61.0,39.0
21.846153846153847,13,9,4,69.0,31.0
9.5,14,10,4,71.0,29.0
14.23076923076923,13,10,3,77.0,23.0
31.6,5,2,3,40.0,60.0
14.25,4,4,0,100.0,0.0
107.66666666666667,3,3,0,100.0,0.0
3.0,1,1,0,100.0,0.0
269.0,1,1,0,100.0,0.0
4.0,1,1,0,100.0,0.0
7.0,1,1,0,100.0,0.0
4.0,3,3,0,100.0,0.0
10.714285714285714,7,6,1,86.0,14.0
11.636363636363637,11,10,1,91.0,9.0
12.142857142857142,7,7,0,100.0,0.0
25.09090909090909,11,10,1,91.0,9.0
34.26315789473684,19,17,2,89.0,11.0
17.72222222222222,18,15,3,83.0,17.0
25.666666666666668,30,20,10,67.0,33.0
20.52,25,15,10,60.0,40.0
8.916666666666666,12,10,2,83.0,17.0
17.53846153846154,13,11,2,85.0,15.0
10.0,12,11,1,92.0,8.0
12.5,8,8,0,100.0,0.0
21.23076923076923,13,7,6,54.0,46.0
12.857142857142858,7,7,0,100.0,0.0
17.5,4,2,2,50.0,50.0
30.8,5,5,0,100.0,0.0
2.0,2,2,0,100.0,0.0
3.0,1,1,0,100.0,0.0
8.0,4,4,0,100.0,0.0
9.75,8,8,0,100.0,0.0
11.592592592592593,27,25,2,93.0,7.0
15.181818181818182,44,39,5,89.0,11.0
17.785714285714285,28,24,4,86.0,14.0
17.333333333333332,12,10,2,83.0,17.0
21.181818181818183,22,15,7,68.0,32.0
21.055555555555557,18,16,2,89.0,11.0
20.541666666666668,24,17,7,71.0,29.0
29.27777777777778,18,12,6,67.0,33.0
12.892857142857142,28,20,8,71.0,29.0
14.266666666666667,30,24,6,80.0,20.0
14.076923076923077,52,45,7,87.0,13.0
9.827586206896552,29,28,1,97.0,3.0
16.833333333333332,18,15,3,83.0,17.0
8.714285714285714,7,6,1,86.0,14.0
7.444444444444445,9,7,2,78.0,22.0
12.714285714285714,14,10,4,71.0,29.0
10.125,8,5,3,62.0,38.0
6.0,6,4,2,67.0,33.0
28.0,1,1,0,100.0,0.0
2.0,2,2,0,100.0,0.0
27.0,2,2,0,100.0,0.0
5.0,1,1,0,100.0,0.0
8.5,2,2,0,100.0,0.0
25.5,8,8,0,100.0,0.0
10.210526315789474,19,18,1,95.0,5.0
12.384615384615385,26,24,2,92.0,8.0
5.923076923076923,13,13,0,100.0,0.0
6.571428571428571,7,7,0,100.0,0.0
12.5,16,15,1,94.0,6.0
11.0,12,11,1,92.0,8.0
7.933333333333334,15,14,1,93.0,7.0
14.5,10,10,0,100.0,0.0
8.8,15,13,2,87.0,13.0
13.894736842105264,19,18,1,95.0,5.0
9.647058823529411,34,32,2,94.0,6.0
12.928571428571429,28,27,1,96.0,4.0
25.6,5,3,2,60.0,40.0
39.166666666666664,6,5,1,83.0,17.0
8.153846153846153,13,12,1,92.0,8.0
17.285714285714285,7,4,3,57.0,43.0
6.5,2,2,0,100.0,0.0
17.857142857142858,7,6,1,86.0,14.0
5.0,1,1,0,100.0,0.0
5.0,1,1,0,100.0,0.0
170.0,1,1,0,100.0,0.0
7.0,1,1,0,100.0,0.0
8.625,8,7,1,88.0,12.0
9.61111111111111,18,18,0,100.0,0.0
12.166666666666666,24,22,2,92.0,8.0
13.5,10,9,1,90.0,10.0
15.4,10,7,3,70.0,30.0
19.727272727272727,11,9,2,82.0,18.0
13.89655172413793,29,26,3,90.0,10.0
15.642857142857142,28,25,3,89.0,11.0
11.944444444444445,18,15,3,83.0,17.0
23.0625,16,13,3,81.0,19.0
15.782608695652174,23,19,4,83.0,17.0
12.195652173913043,46,40,6,87.0,13.0
14.25,28,28,0,100.0,0.0
12.714285714285714,7,5,2,71.0,29.0
19.88888888888889,9,9,0,100.0,0.0
10.153846153846153,13,12,1,92.0,8.0
10.571428571428571,7,7,0,100.0,0.0
17.142857142857142,7,7,0,100.0,0.0
3.5,2,2,0,100.0,0.0
75.0,1,1,0,100.0,0.0
8.5,2,2,0,100.0,0.0
11.0,5,4,1,80.0,20.0
8.866666666666667,15,15,0,100.0,0.0
13.0,26,23,3,88.0,12.0
7.764705882352941,17,15,2,88.0,12.0
5.5,4,4,0,100.0,0.0
15.705882352941176,17,16,1,94.0,6.0
16.238095238095237,21,18,3,86.0,14.0
18.047619047619047,21,18,3,86.0,14.0
7.285714285714286,21,21,0,100.0,0.0
6.823529411764706,17,14,3,82.0,18.0
11.80952380952381,21,20,1,95.0,5.0
13.466666666666667,30,26,4,87.0,13.0
10.727272727272727,22,20,2,91.0,9.0
6.666666666666667,9,8,1,89.0,11.0
12.916666666666666,12,12,0,100.0,0.0
15.818181818181818,11,9,2,82.0,18.0
12.555555555555555,9,8,1,89.0,11.0
4.6,5,5,0,100.0,0.0
21.25,4,3,1,75.0,25.0
9.5,2,2,0,100.0,0.0
26.5,2,2,0,100.0,0.0
12.0,1,1,0,100.0,0.0
1.0,1,1,0,100.0,0.0
7.6,10,10,0,100.0,0.0
8.227272727272727,22,19,3,86.0,14.0
16.612903225806452,31,25,6,81.0,19.0
9.130434782608695,23,20,3,87.0,13.0
10.647058823529411,17,13,4,76.0,24.0
13.346153846153847,26,21,5,81.0,19.0
18.0,26,22,4,85.0,15.0
16.789473684210527,19,17,2,89.0,11.0
14.76,25,21,4,84.0,16.0
15.826086956521738,23,20,3,87.0,13.0
13.555555555555555,18,16,2,89.0,11.0
12.853658536585366,41,34,7,83.0,17.0
16.68,25,22,3,88.0,12.0
131.77777777777777,9,8,1,89.0,11.0
22.0,14,14,0,100.0,0.0
15.818181818181818,11,11,0,100.0,0.0
5.25,4,4,0,100.0,0.0
9.5,2,2,0,100.0,0.0
13.0,1,1,0,100.0,0.0
10.666666666666666,3,3,0,100.0,0.0
11.0,1,1,0,100.0,0.0
41.0,1,0,1,0.0,100.0
12.0,1,0,1,0.0,100.0
14.0,7,7,0,100.0,0.0
13.875,8,8,0,100.0,0.0
16.214285714285715,14,11,3,79.0,21.0
30.115384615384617,26,14,12,54.0,46.0
19.807692307692307,26,18,8,69.0,31.0
27.46875,32,23,9,72.0,28.0
23.41176470588235,51,20,31,39.0,61.0
33.56818181818182,44,22,22,50.0,50.0
22.272727272727273,44,19,25,43.0,57.0
15.6,30,25,5,83.0,17.0
8.166666666666666,12,10,2,83.0,17.0
13.375,8,8,0,100.0,0.0
29.666666666666668,6,6,0,100.0,0.0
21.571428571428573,7,5,2,71.0,29.0
16.0,8,7,1,88.0,12.0
6.666666666666667,3,2,1,67.0,33.0
9.75,4,2,2,50.0,50.0
9.5,2,2,0,100.0,0.0
3.0,1,1,0,100.0,0.0
2.0,1,1,0,100.0,0.0
2.0,1,1,0,100.0,0.0
8.5,2,2,0,100.0,0.0
6.333333333333333,3,3,0,100.0,0.0
11.866666666666667,15,11,4,73.0,27.0
10.357142857142858,14,10,4,71.0,29.0
20.941176470588236,34,24,10,71.0,29.0
17.19047619047619,21,12,9,57.0,43.0
26.58823529411765,51,24,27,47.0,53.0
26.347826086956523,46,21,25,46.0,54.0
34.833333333333336,60,20,40,33.0,67.0
32.60493827160494,81,28,53,35.0,65.0
34.608108108108105,74,28,46,38.0,62.0
15.864864864864865,37,23,14,62.0,38.0
18.076923076923077,13,8,5,62.0,38.0
36.608695652173914,23,11,12,48.0,52.0
87.06666666666666,15,11,4,73.0,27.0
14.0,8,6,2,75.0,25.0
47.666666666666664,6,3,3,50.0,50.0
32.2,10,6,4,60.0,40.0
52.5,4,4,0,100.0,0.0
4.333333333333333,3,3,0,100.0,0.0
14.25,4,4,0,100.0,0.0
99.0,1,1,0,100.0,0.0
7.5,2,2,0,100.0,0.0
7.6,10,8,2,80.0,20.0
13.1,30,27,3,90.0,10.0
18.62162162162162,37,33,4,89.0,11.0
14.08,25,23,2,92.0,8.0
10.263157894736842,19,16,3,84.0,16.0
22.9375,16,12,4,75.0,25.0
13.266666666666667,15,13,2,87.0,13.0
16.470588235294116,17,16,1,94.0,6.0
15.266666666666667,15,15,0,100.0,0.0
21.65,20,15,5,75.0,25.0
9.307692307692308,13,10,3,77.0,23.0
14.0,21,18,3,86.0,14.0
14.214285714285714,14,12,2,86.0,14.0
9.0,14,11,3,79.0,21.0
7.0,6,5,1,83.0,17.0
4.75,8,8,0,100.0,0.0
8.6,10,9,1,90.0,10.0
7.8,5,5,0,100.0,0.0
26.666666666666668,3,3,0,100.0,0.0
6.666666666666667,3,3,0,100.0,0.0
27.0,1,1,0,100.0,0.0
4.0,1,1,0,100.0,0.0
5.333333333333333,3,3,0,100.0,0.0
9.916666666666666,12,9,3,75.0,25.0
9.23076923076923,26,20,6,77.0,23.0
13.979166666666666,48,39,9,81.0,19.0
20.956521739130434,23,21,2,91.0,9.0
11.55,20,15,5,75.0,25.0
33.56,25,17,8,68.0,32.0
15.0,37,26,11,70.0,30.0
20.318181818181817,22,11,11,50.0,50.0
15.535714285714286,28,22,6,79.0,21.0
22.91176470588235,34,18,16,53.0,47.0
12.84,50,40,10,80.0,20.0
14.338983050847459,59,44,15,75.0,25.0
16.285714285714285,28,27,1,96.0,4.0
25.3,20,17,3,85.0,15.0
14.384615384615385,13,12,1,92.0,8.0
11.266666666666667,15,14,1,93.0,7.0
17.666666666666668,6,4,2,67.0,33.0
9.714285714285714,7,6,1,86.0,14.0
5.8,5,3,2,60.0,40.0
2.0,1,1,0,100.0,0.0
13.5,4,4,0,100.0,0.0
7.666666666666667,6,6,0,100.0,0.0
7.909090909090909,11,7,4,64.0,36.0
7.2,20,18,2,90.0,10.0
10.226415094339623,53,48,5,91.0,9.0
9.052631578947368,19,16,3,84.0,16.0
9.333333333333334,18,17,1,94.0,6.0
10.666666666666666,30,29,1,97.0,3.0
28.703703703703702,27,21,6,78.0,22.0
15.285714285714286,28,18,10,64.0,36.0
16.5,18,17,1,94.0,6.0
13.91304347826087,23,19,4,83.0,17.0
13.657142857142857,35,34,1,97.0,3.0
18.262295081967213,61,51,10,84.0,16.0
11.8125,32,31,1,97.0,3.0
14.0,23,20,3,87.0,13.0
15.272727272727273,22,18,4,82.0,18.0
64.16666666666667,12,11,1,92.0,8.0
21.666666666666668,9,6,3,67.0,33.0
29.4,5,3,2,60.0,40.0
4.0,2,2,0,100.0,0.0
6.8,5,5,0,100.0,0.0
13.5,2,2,0,100.0,0.0
53.0,1,1,0,100.0,0.0
3.0,2,2,0,100.0,0.0
20.4,5,5,0,100.0,0.0
13.428571428571429,7,6,1,86.0,14.0
10.666666666666666,30,27,3,90.0,10.0
21.6,50,45,5,90.0,10.0
8.636363636363637,33,29,4,88.0,12.0
44.72727272727273,11,9,2,82.0,18.0
13.142857142857142,35,32,3,91.0,9.0
11.826086956521738,23,20,3,87.0,13.0
12.944444444444445,18,15,3,83.0,17.0
10.357142857142858,14,12,2,86.0,14.0
16.625,16,14,2,88.0,12.0
15.4,20,19,1,95.0,5.0
11.11111111111111,36,31,5,86.0,14.0
14.466666666666667,15,14,1,93.0,7.0
17.38888888888889,18,16,2,89.0,11.0
20.42105263157895,19,12,7,63.0,37.0
8.11111111111111,9,9,0,100.0,0.0
18.333333333333332,6,5,1,83.0,17.0
12.1,10,7,3,70.0,30.0
40.6,5,5,0,100.0,0.0
17.5,2,1,1,50.0,50.0
10.0,1,1,0,100.0,0.0
4.0,1,1,0,100.0,0.0
9.5,4,4,0,100.0,0.0
6.9,10,8,2,80.0,20.0
10.5,24,23,1,96.0,4.0
14.183673469387756,49,45,4,92.0,8.0
13.035714285714286,28,26,2,93.0,7.0
9.352941176470589,17,16,1,94.0,6.0
19.833333333333332,24,21,3,88.0,12.0
19.21212121212121,33,28,5,85.0,15.0
25.272727272727273,33,25,8,76.0,24.0
16.307692307692307,26,14,12,54.0,46.0
20.975609756097562,41,27,14,66.0,34.0
16.634615384615383,52,39,13,75.0,25.0
13.706666666666667,75,66,9,88.0,12.0
26.07547169811321,53,34,19,64.0,36.0
24.50769230769231,65,33,32,51.0,49.0
20.75862068965517,29,19,10,66.0,34.0
11.068965517241379,29,16,13,55.0,45.0
34.83673469387755,49,23,26,47.0,53.0
28.363636363636363,22,6,16,27.0,73.0
32.266666666666666,15,7,8,47.0,53.0
50.0,9,5,4,56.0,44.0
21.0,1,1,0,100.0,0.0
7.5,2,0,2,0.0,100.0
18.0,5,3,2,60.0,40.0
84.0,1,1,0,100.0,0.0
26.666666666666668,3,3,0,100.0,0.0
9.4,5,4,1,80.0,20.0
19.0,19,19,0,100.0,0.0
9.933333333333334,15,14,1,93.0,7.0
35.36842105263158,38,22,16,58.0,42.0
20.82857142857143,35,27,8,77.0,23.0
19.02173913043478,46,28,18,61.0,39.0
21.808823529411764,68,31,37,46.0,54.0
26.042857142857144,70,32,38,46.0,54.0
24.322222222222223,90,38,52,42.0,58.0
18.784615384615385,65,30,35,46.0,54.0
17.03125,32,18,14,56.0,44.0
17.7,40,21,19,52.0,48.0
27.29032258064516,31,17,14,55.0,45.0
24.97142857142857,35,19,16,54.0,46.0
21.88235294117647,34,9,25,26.0,74.0
18.2,30,18,12,60.0,40.0
34.041666666666664,24,7,17,29.0,71.0
66.54545454545455,11,3,8,27.0,73.0
63.84615384615385,13,6,7,46.0,54.0
23.142857142857142,7,1,6,14.0,86.0
16.4,5,2,3,40.0,60.0
3.0,1,1,0,100.0,0.0
4.5,2,2,0,100.0,0.0
6.25,4,4,0,100.0,0.0
15.6,15,15,0,100.0,0.0
36.6875,16,13,3,81.0,19.0
29.61904761904762,21,15,6,71.0,29.0
18.115384615384617,26,18,8,69.0,31.0
29.0,35,20,15,57.0,43.0
31.440677966101696,59,18,41,31.0,69.0
18.085714285714285,35,24,11,69.0,31.0
13.75609756097561,41,20,21,49.0,51.0
99.8125,32,19,13,59.0,41.0
17.954545454545453,22,12,10,55.0,45.0
26.727272727272727,11,7,4,64.0,36.0
31.0,15,10,5,67.0,33.0
33.96,25,14,11,56.0,44.0
20.0,16,14,2,88.0,12.0
455.6,5,5,0,100.0,0.0
35.63636363636363,11,9,2,82.0,18.0
6.333333333333333,3,3,0,100.0,0.0
17.666666666666668,3,2,1,67.0,33.0
9.75,4,4,0,100.0,0.0
14.0,1,1,0,100.0,0.0
12.0,1,1,0,100.0,0.0
29.142857142857142,7,4,3,57.0,43.0
5.875,8,8,0,100.0,0.0
12.84375,32,29,3,91.0,9.0
13.637931034482758,58,45,13,78.0,22.0
11.117647058823529,17,17,0,100.0,0.0
14.73913043478261,23,13,10,57.0,43.0
20.636363636363637,22,18,4,82.0,18.0
22.82608695652174,46,29,17,63.0,37.0
18.666666666666668,30,20,10,67.0,33.0
25.69047619047619,42,28,14,67.0,33.0
30.939393939393938,33,19,14,58.0,42.0
17.421875,64,50,14,78.0,22.0
13.571428571428571,56,45,11,80.0,20.0
21.513513513513512,37,30,7,81.0,19.0
17.25,16,13,3,81.0,19.0
12.8125,16,15,1,94.0,6.0
12.666666666666666,9,6,3,67.0,33.0
14.875,8,6,2,75.0,25.0
106.83333333333333,6,6,0,100.0,0.0
11.25,4,4,0,100.0,0.0
16.0,2,2,0,100.0,0.0
4.0,1,1,0,100.0,0.0
2.5,2,2,0,100.0,0.0
114.5,2,2,0,100.0,0.0
8.5,2,2,0,100.0,0.0
9.363636363636363,11,9,2,82.0,18.0
15.071428571428571,28,26,2,93.0,7.0
11.0,55,52,3,95.0,5.0
87.04166666666667,24,22,2,92.0,8.0
8.76923076923077,26,24,2,92.0,8.0
18.7,30,28,2,93.0,7.0
17.31578947368421,38,27,11,71.0,29.0
13.166666666666666,24,17,7,71.0,29.0
25.047619047619047,21,14,7,67.0,33.0
12.5,32,23,9,72.0,28.0
15.163636363636364,55,45,10,82.0,18.0
17.444444444444443,63,51,12,81.0,19.0
15.871794871794872,39,28,11,72.0,28.0
11.181818181818182,33,23,10,70.0,30.0
9.347826086956522,23,21,2,91.0,9.0
37.34782608695652,23,12,11,52.0,48.0
14.916666666666666,12,12,0,100.0,0.0
10.1,10,6,4,60.0,40.0
4.25,4,3,1,75.0,25.0
8.0,1,1,0,100.0,0.0
7.0,1,1,0,100.0,0.0
8.0,5,2,3,40.0,60.0
7.333333333333333,6,6,0,100.0,0.0
28.125,8,7,1,88.0,12.0
7.612903225806452,31,30,1,97.0,3.0
11.607843137254902,51,48,3,94.0,6.0
15.512820512820513,39,34,5,87.0,13.0
22.423076923076923,26,23,3,88.0,12.0
24.951219512195124,41,28,13,68.0,32.0
22.452380952380953,42,25,17,60.0,40.0
26.53488372093023,43,28,15,65.0,35.0
23.025641025641026,39,32,7,82.0,18.0
18.275862068965516,58,38,20,66.0,34.0
20.841269841269842,63,51,12,81.0,19.0
15.523809523809524,63,55,8,87.0,13.0
11.89655172413793,29,24,5,83.0,17.0
13.3,30,22,8,73.0,27.0
18.37037037037037,27,20,7,74.0,26.0
19.294117647058822,17,15,2,88.0,12.0
4.833333333333333,6,6,0,100.0,0.0
10.0,7,5,2,71.0,29.0
9.4,5,5,0,100.0,0.0
3.5,2,2,0,100.0,0.0
9.0,1,1,0,100.0,0.0
6.5,2,2,0,100.0,0.0
51.333333333333336,3,3,0,100.0,0.0
31.333333333333332,6,5,1,83.0,17.0
23.333333333333332,6,5,1,83.0,17.0
10.862068965517242,29,27,2,93.0,7.0
9.0,49,46,3,94.0,6.0
15.5,28,25,3,89.0,11.0
23.333333333333332,21,16,5,76.0,24.0
19.405405405405407,37,26,11,70.0,30.0
35.94117647058823,34,21,13,62.0,38.0
13.707317073170731,41,33,8,80.0,20.0
15.121212121212121,33,19,14,58.0,42.0
39.25925925925926,54,33,21,61.0,39.0
11.906976744186046,43,38,5,88.0,12.0
16.333333333333332,57,50,7,88.0,12.0
15.1,50,34,16,68.0,32.0
19.136363636363637,22,18,4,82.0,18.0
13.423076923076923,26,21,5,81.0,19.0
32.0,12,10,2,83.0,17.0
19.5,14,8,6,57.0,43.0
13.4,10,9,1,90.0,10.0
45.666666666666664,6,1,5,17.0,83.0
17.75,4,2,2,50.0,50.0
57.0,1,1,0,100.0,0.0
176.0,1,1,0,100.0,0.0
20.75,4,4,0,100.0,0.0
7.2,5,5,0,100.0,0.0
17.142857142857142,7,6,1,86.0,14.0
10.157894736842104,38,35,3,92.0,8.0
14.842105263157896,57,50,7,88.0,12.0
21.324324324324323,37,28,9,76.0,24.0
21.580645161290324,31,22,9,71.0,29.0
21.733333333333334,45,21,24,47.0,53.0
40.588235294117645,34,20,14,59.0,41.0
19.829787234042552,47,22,25,47.0,53.0
22.0625,48,26,22,54.0,46.0
20.771428571428572,35,25,10,71.0,29.0
19.07936507936508,63,37,26,59.0,41.0
13.766666666666667,60,50,10,83.0,17.0
12.783783783783784,37,31,6,84.0,16.0
59.958333333333336,24,13,11,54.0,46.0
16.5,12,9,3,75.0,25.0
23.4,25,14,11,56.0,44.0
10.9,10,8,2,80.0,20.0
17.88888888888889,9,7,2,78.0,22.0
13.833333333333334,6,6,0,100.0,0.0
20.6,5,4,1,80.0,20.0
47.5,2,2,0,100.0,0.0
43.0,1,1,0,100.0,0.0
16.0,1,1,0,100.0,0.0
25.0,1,1,0,100.0,0.0
3.1666666666666665,6,6,0,100.0,0.0
3.0,5,5,0,100.0,0.0
7.583333333333333,12,10,2,83.0,17.0
26.94736842105263,19,11,8,58.0,42.0
32.142857142857146,35,20,15,57.0,43.0
42.614285714285714,70,19,51,27.0,73.0
40.582089552238806,67,20,47,30.0,70.0
38.0,75,20,55,27.0,73.0
23.924050632911392,79,27,52,34.0,66.0
24.903225806451612,93,25,68,27.0,73.0
30.65740740740741,108,18,90,17.0,83.0
20.396825396825395,63,22,41,35.0,65.0
15.377358490566039,53,29,24,55.0,45.0
11.625,24,13,11,54.0,46.0
21.363636363636363,11,8,3,73.0,27.0
8.833333333333334,18,14,4,78.0,22.0
13.25,12,8,4,67.0,33.0
13.5,8,4,4,50.0,50.0
9.75,8,4,4,50.0,50.0
18.5,4,4,0,100.0,0.0
101.25,4,4,0,100.0,0.0
8.833333333333334,6,3,3,50.0,50.0
8.0,3,2,1,67.0,33.0
7.0,2,2,0,100.0,0.0
6.4,5,3,2,60.0,40.0
18.25,8,4,4,50.0,50.0
22.36842105263158,19,14,5,74.0,26.0
41.357142857142854,14,8,6,57.0,43.0
50.61224489795919,49,18,31,37.0,63.0
21.425925925925927,54,20,34,37.0,63.0
30.814285714285713,70,19,51,27.0,73.0
23.691176470588236,68,27,41,40.0,60.0
24.569444444444443,72,27,45,38.0,62.0
30.964912280701753,57,20,37,35.0,65.0
16.565217391304348,69,32,37,46.0,54.0
16.857142857142858,49,23,26,47.0,53.0
11.1875,32,18,14,56.0,44.0
17.095238095238095,21,5,16,24.0,76.0
23.6875,16,10,6,62.0,38.0
7.555555555555555,9,6,3,67.0,33.0
13.5,8,7,1,88.0,12.0
10.375,8,5,3,62.0,38.0
27.666666666666668,3,3,0,100.0,0.0
16.5,4,3,1,75.0,25.0
32.0,2,2,0,100.0,0.0
9.0,1,1,0,100.0,0.0
7.0,1,0,1,0.0,100.0
7.5,4,4,0,100.0,0.0
8.666666666666666,9,9,0,100.0,0.0
9.3125,32,23,9,72.0,28.0
11.980392156862745,51,42,9,82.0,18.0
14.590909090909092,22,17,5,77.0,23.0
42.25,32,20,12,62.0,38.0
28.05,40,26,14,65.0,35.0
18.55263157894737,38,31,7,82.0,18.0
24.526315789473685,38,26,12,68.0,32.0
31.2,35,17,18,49.0,51.0
40.06060606060606,33,22,11,67.0,33.0
13.019607843137255,51,40,11,78.0,22.0
17.446153846153845,65,56,9,86.0,14.0
13.0,29,24,5,83.0,17.0
14.833333333333334,24,20,4,83.0,17.0
13.380952380952381,21,20,1,95.0,5.0
14.0,13,13,0,100.0,0.0
13.846153846153847,13,9,4,69.0,31.0
36.57142857142857,7,4,3,57.0,43.0
4.333333333333333,3,3,0,100.0,0.0
52.25,4,2,2,50.0,50.0
102.0,1,0,1,0.0,100.0
17.0,1,1,0,100.0,0.0
15.666666666666666,3,2,1,67.0,33.0
5.615384615384615,13,12,1,92.0,8.0
13.6875,32,23,9,72.0,28.0
22.50980392156863,51,41,10,80.0,20.0
9.416666666666666,24,18,6,75.0,25.0
15.222222222222221,18,14,4,78.0,22.0
17.333333333333332,33,30,3,91.0,9.0
27.307692307692307,39,30,9,77.0,23.0
15.903225806451612,31,24,7,77.0,23.0
25.814814814814813,27,20,7,74.0,26.0
27.651162790697676,43,36,7,84.0,16.0
16.8125,32,23,9,72.0,28.0
29.507462686567163,67,52,15,78.0,22.0
16.0,33,25,8,76.0,24.0
15.347826086956522,23,18,5,78.0,22.0
14.833333333333334,18,16,2,89.0,11.0
14.166666666666666,6,3,3,50.0,50.0
15.333333333333334,12,9,3,75.0,25.0
33.5,4,4,0,100.0,0.0
7.25,4,3,1,75.0,25.0
8.0,1,1,0,100.0,0.0
4.0,1,1,0,100.0,0.0
15.0,4,4,0,100.0,0.0
8.0,1,1,0,100.0,0.0
11.0,4,2,2,50.0,50.0
9.15,20,16,4,80.0,20.0
11.457142857142857,35,32,3,91.0,9.0
11.772727272727273,22,17,5,77.0,23.0
12.066666666666666,15,12,3,80.0,20.0
19.68,25,19,6,76.0,24.0
23.29032258064516,31,22,9,71.0,29.0
26.642857142857142,28,20,8,71.0,29.0
16.541666666666668,24,20,4,83.0,17.0
15.0,22,21,1,95.0,5.0
10.628571428571428,35,32,3,91.0,9.0
13.456521739130435,46,42,4,91.0,9.0
16.68,25,21,4,84.0,16.0
19.625,24,15,9,62.0,38.0
15.789473684210526,19,12,7,63.0,37.0
17.142857142857142,14,10,4,71.0,29.0
8.956521739130435,23,17,6,74.0,26.0
33.25,4,3,1,75.0,25.0
16.666666666666668,3,2,1,67.0,33.0
15.0,2,2,0,100.0,0.0
7.5,2,2,0,100.0,0.0
11.0,5,4,1,80.0,20.0
184.33333333333334,6,6,0,100.0,0.0
6.8,5,3,2,60.0,40.0
10.346153846153847,26,23,3,88.0,12.0
11.804347826086957,46,40,6,87.0,13.0
15.515151515151516,33,24,9,73.0,27.0
29.357142857142858,14,10,4,71.0,29.0
27.90625,32,23,9,72.0,28.0
25.02857142857143,35,21,14,60.0,40.0
24.29032258064516,31,19,12,61.0,39.0
10.52,25,17,8,68.0,32.0
17.88235294117647,34,22,12,65.0,35.0
13.046511627906977,43,31,12,72.0,28.0
11.865671641791044,67,53,14,79.0,21.0
15.6,45,30,15,67.0,33.0
14.45,20,16,4,80.0,20.0
15.5,22,20,2,91.0,9.0
14.0,13,9,4,69.0,31.0
17.454545454545453,11,11,0,100.0,0.0
30.46153846153846,13,9,4,69.0,31.0
20.333333333333332,3,3,0,100.0,0.0
53.8,5,3,2,60.0,40.0
34.0,2,1,1,50.0,50.0
27.0,2,2,0,100.0,0.0
10.333333333333334,3,3,0,100.0,0.0
9.0,3,3,0,100.0,0.0
10.5,6,6,0,100.0,0.0
9.714285714285714,21,20,1,95.0,5.0
20.852941176470587,34,32,2,94.0,6.0
13.26923076923077,26,17,9,65.0,35.0
26.4,15,11,4,73.0,27.0
24.892857142857142,28,19,9,68.0,32.0
22.21875,32,24,8,75.0,25.0
22.852941176470587,34,16,18,47.0,53.0
17.0,19,10,9,53.0,47.0
22.772727272727273,44,24,20,55.0,45.0
15.71111111111111,45,26,19,58.0,42.0
15.106060606060606,66,49,17,74.0,26.0
14.392857142857142,28,23,5,82.0,18.0
20.653846153846153,26,18,8,69.0,31.0
11.555555555555555,9,9,0,100.0,0.0
18.454545454545453,11,9,2,82.0,18.0
7.142857142857143,14,13,1,93.0,7.0
6.666666666666667,3,3,0,100.0,0.0
5.5,2,1,1,50.0,50.0
17.0,1,0,1,0.0,100.0
12.5,2,2,0,100.0,0.0
50.0,1,0,1,0.0,100.0
16.4,5,2,3,40.0,60.0
18.5,2,1,1,50.0,50.0
10.428571428571429,7,6,1,86.0,14.0
8.285714285714286,7,7,0,100.0,0.0
43.111111111111114,9,8,1,89.0,11.0
17.53846153846154,13,9,4,69.0,31.0
13.933333333333334,15,7,8,47.0,53.0
27.416666666666668,24,12,12,50.0,50.0
17.945945945945947,37,19,18,51.0,49.0
32.08163265306123,49,17,32,35.0,65.0
14.72,50,21,29,42.0,58.0
31.105263157894736,38,16,22,42.0,58.0
18.228571428571428,35,19,16,54.0,46.0
25.894736842105264,19,8,11,42.0,58.0
26.0,31,18,13,58.0,42.0
11.1875,16,10,6,62.0,38.0
12.846153846153847,13,11,2,85.0,15.0
23.727272727272727,11,8,3,73.0,27.0
13.428571428571429,7,7,0,100.0,0.0
9.8,5,1,4,20.0,80.0
10.4,5,3,2,60.0,40.0
34.5,2,2,0,100.0,0.0
3.5,2,1,1,50.0,50.0
8.0,2,2,0,100.0,0.0
12.916666666666666,12,9,3,75.0,25.0
34.857142857142854,7,3,4,43.0,57.0
35.0,13,6,7,46.0,54.0
21.833333333333332,18,13,5,72.0,28.0
24.666666666666668,9,4,5,44.0,56.0
31.0,8,8,0,100.0,0.0
35.0,4,4,0,100.0,0.0
75.11111111111111,18,15,3,83.0,17.0
21.958333333333332,24,10,14,42.0,58.0
21.22222222222222,9,7,2,78.0,22.0
9.333333333333334,6,6,0,100.0,0.0
4.0,1,1,0,100.0,0.0
6.0,2,2,0,100.0,0.0
17.0,1,1,0,100.0,0.0
6.0,1,1,0,100.0,0.0
10.5,2,2,0,100.0,0.0
20.0,1,1,0,100.0,0.0
12.0,1,1,0,100.0,0.0
18.0,1,1,0,100.0,0.0
25.5,8,7,1,88.0,12.0
12.0,11,10,1,91.0,9.0
7.428571428571429,7,7,0,100.0,0.0
48.81818181818182,11,8,3,73.0,27.0
19.833333333333332,18,11,7,61.0,39.0
24.1,20,14,6,70.0,30.0
14.5,34,23,11,68.0,32.0
22.88888888888889,27,12,15,44.0,56.0
16.137931034482758,29,20,9,69.0,31.0
27.3125,48,23,25,48.0,52.0
22.486486486486488,37,23,14,62.0,38.0
12.041666666666666,24,21,3,88.0,12.0
6.5,10,8,2,80.0,20.0
7.0,6,5,1,83.0,17.0
7.285714285714286,14,12,2,86.0,14.0
18.6,5,5,0,100.0,0.0
6.666666666666667,6,5,1,83.0,17.0
3.3333333333333335,3,1,2,33.0,67.0
19.2,5,1,4,20.0,80.0
31.0,2,2,0,100.0,0.0
16.0,1,1,0,100.0,0.0
8.8,5,4,1,80.0,20.0
6.75,4,3,1,75.0,25.0
21.545454545454547,11,11,0,100.0,0.0
10.72,25,24,1,96.0,4.0
16.666666666666668,15,15,0,100.0,0.0
12.6,10,7,3,70.0,30.0
11.666666666666666,9,7,2,78.0,22.0
6.5,10,10,0,100.0,0.0
10.454545454545455,11,10,1,91.0,9.0
35.625,8,7,1,88.0,12.0
11.8,15,14,1,93.0,7.0
12.0,14,13,1,93.0,7.0
10.166666666666666,18,18,0,100.0,0.0
77.61538461538461,13,13,0,100.0,0.0
12.0,1,1,0,100.0,0.0
5.0,1,1,0,100.0,0.0
98.5,2,2,0,100.0,0.0
29.0,1,1,0,100.0,0.0
32.0,2,1,1,50.0,50.0
207.5,2,2,0,100.0,0.0
18.333333333333332,3,3,0,100.0,0.0
20.0,2,2,0,100.0,0.0
70.0,2,2,0,100.0,0.0
19.0,1,1,0,100.0,0.0
20.4,5,5,0,100.0,0.0
8.8,5,5,0,100.0,0.0
20.333333333333332,3,3,0,100.0,0.0
9.833333333333334,6,6,0,100.0,0.0
17.666666666666668,12,12,0,100.0,0.0
27.0,12,9,3,75.0,25.0
9.470588235294118,17,11,6,65.0,35.0
14.333333333333334,21,15,6,71.0,29.0
15.55,40,33,7,82.0,18.0
12.08,25,22,3,88.0,12.0
9.727272727272727,11,11,0,100.0,0.0
12.083333333333334,12,8,4,67.0,33.0
37.0,4,3,1,75.0,25.0
13.571428571428571,7,6,1,86.0,14.0
13.0,1,1,0,100.0,0.0
5.0,2,2,0,100.0,0.0
5.4,5,5,0,100.0,0.0
36.857142857142854,7,6,1,86.0,14.0
9.23076923076923,13,11,2,85.0,15.0
13.181818181818182,11,11,0,100.0,0.0
11.090909090909092,11,11,0,100.0,0.0
12.333333333333334,9,5,4,56.0,44.0
14.333333333333334,12,11,1,92.0,8.0
17.272727272727273,11,10,1,91.0,9.0
16.3125,16,13,3,81.0,19.0
8.454545454545455,22,18,4,82.0,18.0
12.65625,32,24,8,75.0,25.0
15.16,50,41,9,82.0,18.0
26.178571428571427,28,24,4,86.0,14.0
8.782608695652174,23,22,1,96.0,4.0
10.846153846153847,13,13,0,100.0,0.0
8.923076923076923,13,10,3,77.0,23.0
12.333333333333334,3,3,0,100.0,0.0
14.875,8,6,2,75.0,25.0
23.0,1,0,1,0.0,100.0
64.0,1,1,0,100.0,0.0
22.666666666666668,3,3,0,100.0,0.0
18.0,1,1,0,100.0,0.0
7.6,5,5,0,100.0,0.0
10.2,5,4,1,80.0,20.0
13.5,16,16,0,100.0,0.0
10.685714285714285,35,32,3,91.0,9.0
10.68421052631579,19,16,3,84.0,16.0
36.3,20,16,4,80.0,20.0
13.066666666666666,15,11,4,73.0,27.0
17.25925925925926,27,19,8,70.0,30.0
11.736842105263158,19,14,5,74.0,26.0
19.25,16,9,7,56.0,44.0
12.153846153846153,26,19,7,73.0,27.0
11.678571428571429,28,27,1,96.0,4.0
10.710526315789474,38,32,6,84.0,16.0
11.25,28,28,0,100.0,0.0
67.625,8,7,1,88.0,12.0
11.375,8,6,2,75.0,25.0
14.3,10,9,1,90.0,10.0
7.5,8,8,0,100.0,0.0
10.666666666666666,3,3,0,100.0,0.0
57.0,1,1,0,100.0,0.0
4.0,1,1,0,100.0,0.0
15.5,2,1,1,50.0,50.0
11.5,2,2,0,100.0,0.0
6.0,1,1,0,100.0,0.0
8.666666666666666,3,1,2,33.0,67.0
2.0,1,1,0,100.0,0.0
15.833333333333334,6,3,3,50.0,50.0
24.363636363636363,11,11,0,100.0,0.0
21.76923076923077,26,14,12,54.0,46.0
20.52,25,14,11,56.0,44.0
32.64,25,11,14,44.0,56.0
25.967741935483872,31,18,13,58.0,42.0
17.333333333333332,42,18,24,43.0,57.0
66.78378378378379,37,12,25,32.0,68.0
19.6,45,20,25,44.0,56.0
12.318181818181818,22,13,9,59.0,41.0
12.823529411764707,17,12,5,71.0,29.0
23.0,11,7,4,64.0,36.0
23.0,10,10,0,100.0,0.0
22.0,17,11,6,65.0,35.0
19.266666666666666,15,10,5,67.0,33.0
20.3,10,8,2,80.0,20.0
12.666666666666666,3,2,1,67.0,33.0
5.333333333333333,3,3,0,100.0,0.0
15.5,4,3,1,75.0,25.0
15.0,2,1,1,50.0,50.0
2.0,1,1,0,100.0,0.0
14.25,4,3,1,75.0,25.0
4.0,1,1,0,100.0,0.0
7.285714285714286,7,5,2,71.0,29.0
22.77777777777778,9,9,0,100.0,0.0
12.166666666666666,6,6,0,100.0,0.0
12.4,10,10,0,100.0,0.0
10.142857142857142,7,6,1,86.0,14.0
14.733333333333333,15,11,4,73.0,27.0
13.0,11,10,1,91.0,9.0
5.6923076923076925,13,12,1,92.0,8.0
7.625,8,8,0,100.0,0.0
16.6,15,14,1,93.0,7.0
16.333333333333332,12,7,5,58.0,42.0
8.0,7,7,0,100.0,0.0
20.6,5,4,1,80.0,20.0
15.0,3,2,1,67.0,33.0
13.571428571428571,7,7,0,100.0,0.0
12.666666666666666,3,3,0,100.0,0.0
5.333333333333333,3,2,1,67.0,33.0
6.5,2,2,0,100.0,0.0
18.333333333333332,3,3,0,100.0,0.0
9.0,2,2,0,100.0,0.0
6.818181818181818,11,11,0,100.0,0.0
13.210526315789474,19,16,3,84.0,16.0
9.27027027027027,37,34,3,92.0,8.0
10.866666666666667,15,13,2,87.0,13.0
22.19047619047619,21,18,3,86.0,14.0
27.25,16,16,0,100.0,0.0
13.676470588235293,34,25,9,74.0,26.0
23.392857142857142,28,20,8,71.0,29.0
30.022727272727273,44,25,19,57.0,43.0
17.32,25,22,3,88.0,12.0
15.393939393939394,33,27,6,82.0,18.0
13.087719298245615,57,50,7,88.0,12.0
12.310344827586206,29,26,3,90.0,10.0
11.789473684210526,19,15,4,79.0,21.0
14.857142857142858,14,14,0,100.0,0.0
4.333333333333333,9,9,0,100.0,0.0
10.88888888888889,9,8,1,89.0,11.0
4.75,4,4,0,100.0,0.0
13.0,1,1,0,100.0,0.0
7.0,1,1,0,100.0,0.0
13.0,1,1,0,100.0,0.0
16.0,1,0,1,0.0,100.0
8.0,1,1,0,100.0,0.0
18.5,4,2,2,50.0,50.0
8.666666666666666,9,9,0,100.0,0.0
10.421052631578947,19,17,2,89.0,11.0
12.702702702702704,37,36,1,97.0,3.0
30.857142857142858,21,18,3,86.0,14.0
14.4,25,19,6,76.0,24.0
21.714285714285715,21,20,1,95.0,5.0
17.041666666666668,24,20,4,83.0,17.0
11.857142857142858,21,20,1,95.0,5.0
9.944444444444445,18,17,1,94.0,6.0
97.4074074074074,27,22,5,81.0,19.0
15.0,40,29,11,72.0,28.0
16.705882352941178,51,44,7,86.0,14.0
19.545454545454547,22,21,1,95.0,5.0
13.588235294117647,17,16,1,94.0,6.0
10.785714285714286,14,13,1,93.0,7.0
7.888888888888889,9,8,1,89.0,11.0
9.5,8,7,1,88.0,12.0
9.5,2,2,0,100.0,0.0
212.0,6,3,3,50.0,50.0
4.0,1,1,0,100.0,0.0
28.0,1,1,0,100.0,0.0
10.0,2,2,0,100.0,0.0
24.666666666666668,3,2,1,67.0,33.0
9.166666666666666,6,6,0,100.0,0.0
9.714285714285714,21,18,3,86.0,14.0
10.82857142857143,35,31,4,89.0,11.0
7.909090909090909,11,10,1,91.0,9.0
25.454545454545453,11,7,4,64.0,36.0
18.105263157894736,19,19,0,100.0,0.0
9.866666666666667,15,15,0,100.0,0.0
32.38461538461539,13,13,0,100.0,0.0
12.272727272727273,11,9,2,82.0,18.0
10.2,10,8,2,80.0,20.0
13.944444444444445,18,18,0,100.0,0.0
9.486486486486486,37,33,4,89.0,11.0
23.157894736842106,19,18,1,95.0,5.0
8.307692307692308,13,11,2,85.0,15.0
7.777777777777778,9,9,0,100.0,0.0
8.0,8,8,0,100.0,0.0
4.5,2,2,0,100.0,0.0
7.25,4,4,0,100.0,0.0
3.5,2,2,0,100.0,0.0
7.0,1,1,0,100.0,0.0
4.0,1,1,0,100.0,0.0
8.5,2,2,0,100.0,0.0
14.375,8,8,0,100.0,0.0
10.0,3,2,1,67.0,33.0
9.5,28,26,2,93.0,7.0
10.8,50,47,3,94.0,6.0
35.54545454545455,22,22,0,100.0,0.0
19.454545454545453,22,19,3,86.0,14.0
11.578947368421053,38,28,10,74.0,26.0
14.838709677419354,31,22,9,71.0,29.0
17.73170731707317,41,25,16,61.0,39.0
18.294117647058822,17,13,4,76.0,24.0
12.344827586206897,29,22,7,76.0,24.0
11.24,25,23,2,92.0,8.0
11.804347826086957,46,38,8,83.0,17.0
15.0,26,23,3,88.0,12.0
13.944444444444445,18,13,5,72.0,28.0
10.833333333333334,12,11,1,92.0,8.0
10.363636363636363,11,9,2,82.0,18.0
17.8,15,7,8,47.0,53.0
13.0,5,5,0,100.0,0.0
42.8,5,4,1,80.0,20.0
14.0,1,1,0,100.0,0.0
11.0,1,1,0,100.0,0.0
37.333333333333336,3,3,0,100.0,0.0
21.25,4,4,0,100.0,0.0
8.333333333333334,3,3,0,100.0,0.0
11.0,9,8,1,89.0,11.0
10.88888888888889,18,18,0,100.0,0.0
9.627450980392156,51,45,6,88.0,12.0
9.15,20,14,6,70.0,30.0
20.636363636363637,22,17,5,77.0,23.0
15.590909090909092,22,17,5,77.0,23.0
19.91304347826087,23,19,4,83.0,17.0
12.705882352941176,34,20,14,59.0,41.0
24.933333333333334,30,16,14,53.0,47.0
27.5,34,17,17,50.0,50.0
20.755555555555556,45,17,28,38.0,62.0
13.411764705882353,68,48,20,71.0,29.0
22.08108108108108,37,25,12,68.0,32.0
8.588235294117647,17,14,3,82.0,18.0
10.153846153846153,13,8,5,62.0,38.0
20.23076923076923,13,10,3,77.0,23.0
22.066666666666666,15,7,8,47.0,53.0
15.428571428571429,21,7,14,33.0,67.0
16.0,13,7,6,54.0,46.0
12.75,8,5,3,62.0,38.0
24.375,8,6,2,75.0,25.0
65.0,2,2,0,100.0,0.0
26.25,4,4,0,100.0,0.0
5.5,2,2,0,100.0,0.0
64.0,8,8,0,100.0,0.0
8.923076923076923,13,10,3,77.0,23.0
19.47826086956522,23,16,7,70.0,30.0
28.06451612903226,31,15,16,48.0,52.0
47.59154929577465,71,28,43,39.0,61.0
32.42857142857143,84,27,57,32.0,68.0
18.881720430107528,93,33,60,35.0,65.0
31.724137931034484,87,34,53,39.0,61.0
31.75609756097561,82,22,60,27.0,73.0
29.08695652173913,46,13,33,28.0,72.0
23.0,74,34,40,46.0,54.0
17.555555555555557,45,28,17,62.0,38.0
26.16,25,10,15,40.0,60.0
18.692307692307693,13,10,3,77.0,23.0
27.636363636363637,22,15,7,68.0,32.0
17.125,16,8,8,50.0,50.0
21.5,18,9,9,50.0,50.0
38.25,4,2,2,50.0,50.0
29.0,3,3,0,100.0,0.0
14.666666666666666,3,2,1,67.0,33.0
66.0,1,1,0,100.0,0.0
7.6,5,5,0,100.0,0.0
22.0,1,0,1,0.0,100.0
5.0,3,2,1,67.0,33.0
57.5,10,9,1,90.0,10.0
17.0,25,21,4,84.0,16.0
19.153846153846153,26,12,14,46.0,54.0
32.1,30,17,13,57.0,43.0
37.95,40,13,27,32.0,68.0
24.24390243902439,41,23,18,56.0,44.0
27.512820512820515,39,16,23,41.0,59.0
36.609756097560975,41,16,25,39.0,61.0
34.12903225806452,31,15,16,48.0,52.0
28.048780487804876,41,22,19,54.0,46.0
15.72,25,15,10,60.0,40.0
17.96153846153846,26,14,12,54.0,46.0
15.857142857142858,14,10,4,71.0,29.0
17.0,11,8,3,73.0,27.0
15.9375,16,12,4,75.0,25.0
15.0,5,5,0,100.0,0.0
13.25,4,4,0,100.0,0.0
9.8,5,5,0,100.0,0.0
9.6,5,1,4,20.0,80.0
25.75,4,4,0,100.0,0.0
43.25,4,3,1,75.0,25.0
11.0,2,2,0,100.0,0.0
6.166666666666667,6,6,0,100.0,0.0
51.15384615384615,13,10,3,77.0,23.0
10.958333333333334,24,23,1,96.0,4.0
14.529411764705882,34,31,3,91.0,9.0
16.57894736842105,19,14,5,74.0,26.0
22.923076923076923,13,12,1,92.0,8.0
20.433333333333334,30,21,9,70.0,30.0
22.93103448275862,29,24,5,83.0,17.0
19.65714285714286,35,19,16,54.0,46.0
40.89090909090909,55,28,27,51.0,49.0
31.25,36,24,12,67.0,33.0
15.169811320754716,53,39,14,74.0,26.0
14.75,76,63,13,83.0,17.0
14.030303030303031,33,29,4,88.0,12.0
11.62962962962963,27,21,6,78.0,22.0
19.428571428571427,21,16,5,76.0,24.0
24.058823529411764,17,17,0,100.0,0.0
99.0,7,6,1,86.0,14.0
14.0,10,6,4,60.0,40.0
26.285714285714285,7,5,2,71.0,29.0
4.8,5,4,1,80.0,20.0
6.0,1,1,0,100.0,0.0
26.333333333333332,3,3,0,100.0,0.0
10.75,4,4,0,100.0,0.0
7.25,4,4,0,100.0,0.0
7.461538461538462,13,12,1,92.0,8.0
8.631578947368421,38,38,0,100.0,0.0
8.946428571428571,56,51,5,91.0,9.0
18.0,21,16,5,76.0,24.0
32.724137931034484,29,26,3,90.0,10.0
15.096774193548388,31,16,15,52.0,48.0
17.636363636363637,55,40,15,73.0,27.0
31.682926829268293,41,30,11,73.0,27.0
16.512820512820515,39,27,12,69.0,31.0
18.224137931034484,58,38,20,66.0,34.0
18.189873417721518,79,56,23,71.0,29.0
15.142857142857142,84,66,18,79.0,21.0
23.796296296296298,54,34,20,63.0,37.0
20.705882352941178,34,17,17,50.0,50.0
25.06451612903226,31,12,19,39.0,61.0
14.7,20,15,5,75.0,25.0
69.6,10,10,0,100.0,0.0
23.5,4,3,1,75.0,25.0
17.375,8,5,3,62.0,38.0
9.0,2,1,1,50.0,50.0
39.0,4,1,3,25.0,75.0
5.0,1,1,0,100.0,0.0
6.666666666666667,6,6,0,100.0,0.0
17.333333333333332,15,10,5,67.0,33.0
9.029411764705882,34,29,5,85.0,15.0
17.686274509803923,51,43,8,84.0,16.0
19.321428571428573,28,21,7,75.0,25.0
31.62962962962963,27,20,7,74.0,26.0
27.57777777777778,45,25,20,56.0,44.0
11.2,45,37,8,82.0,18.0
13.068965517241379,29,22,7,76.0,24.0
25.657894736842106,38,19,19,50.0,50.0
19.78787878787879,33,21,12,64.0,36.0
17.092307692307692,65,51,14,78.0,22.0
13.352941176470589,51,45,6,88.0,12.0
12.704545454545455,44,42,2,95.0,5.0
21.303030303030305,33,27,6,82.0,18.0
29.285714285714285,21,16,5,76.0,24.0
15.333333333333334,15,10,5,67.0,33.0
6.636363636363637,11,11,0,100.0,0.0
309.6,5,5,0,100.0,0.0
3.0,1,1,0,100.0,0.0
30.2,5,2,3,40.0,60.0
6.5,4,4,0,100.0,0.0
16.0,1,1,0,100.0,0.0
11.857142857142858,7,7,0,100.0,0.0
6.333333333333333,6,5,1,83.0,17.0
7.16,25,24,1,96.0,4.0
15.25925925925926,27,25,2,93.0,7.0
13.066666666666666,15,14,1,93.0,7.0
8.0,5,4,1,80.0,20.0
10.75,16,15,1,94.0,6.0
14.44,25,18,7,72.0,28.0
110.72727272727273,11,9,2,82.0,18.0
11.391304347826088,23,19,4,83.0,17.0
19.636363636363637,22,16,6,73.0,27.0
11.0,43,38,5,88.0,12.0
10.714285714285714,49,41,8,84.0,16.0
9.222222222222221,18,17,1,94.0,6.0
12.619047619047619,21,18,3,86.0,14.0
9.470588235294118,17,16,1,94.0,6.0
12.272727272727273,11,10,1,91.0,9.0
8.166666666666666,6,6,0,100.0,0.0
9.5,8,7,1,88.0,12.0
4.0,1,0,1,0.0,100.0
1.0,2,1,1,50.0,50.0
17.0,8,5,3,62.0,38.0
18.0,2,2,0,100.0,0.0
7.5,2,2,0,100.0,0.0
6.0,3,3,0,100.0,0.0
23.384615384615383,13,13,0,100.0,0.0
14.451612903225806,31,28,3,90.0,10.0
10.395833333333334,48,36,12,75.0,25.0
10.944444444444445,36,17,19,47.0,53.0
22.5609756097561,41,17,24,41.0,59.0
16.876923076923077,65,34,31,52.0,48.0
26.125,56,18,38,32.0,68.0
25.5375,80,26,54,32.0,68.0
20.629032258064516,62,31,31,50.0,50.0
23.4375,48,32,16,67.0,33.0
19.084745762711865,59,28,31,47.0,53.0
16.96825396825397,63,49,14,78.0,22.0
18.15625,32,21,11,66.0,34.0
23.52173913043478,23,13,10,57.0,43.0
15.458333333333334,24,14,10,58.0,42.0
13.956521739130435,23,17,6,74.0,26.0
21.904761904761905,21,10,11,48.0,52.0
7.916666666666667,12,6,6,50.0,50.0
12.2,5,5,0,100.0,0.0
31.0,8,3,5,38.0,62.0
25.0,5,4,1,80.0,20.0
132.0,2,2,0,100.0,0.0
121.66666666666667,3,2,1,67.0,33.0
9.9,10,10,0,100.0,0.0
23.642857142857142,28,19,9,68.0,32.0
26.45945945945946,37,18,19,49.0,51.0
17.64406779661017,59,20,39,34.0,66.0
35.47422680412371,97,27,70,28.0,72.0
28.98148148148148,108,32,76,30.0,70.0
35.18709677419355,155,32,123,21.0,79.0
32.56547619047619,168,32,136,19.0,81.0
30.856,125,31,94,25.0,75.0
29.630434782608695,138,31,107,22.0,78.0
31.606299212598426,127,39,88,31.0,69.0
25.60759493670886,79,29,50,37.0,63.0
19.22222222222222,36,16,20,44.0,56.0
13.45945945945946,37,21,16,57.0,43.0
24.08,25,10,15,40.0,60.0
18.76,25,11,14,44.0,56.0
10.217391304347826,23,13,10,57.0,43.0
14.3125,16,9,7,56.0,44.0
27.833333333333332,6,2,4,33.0,67.0
13.0,4,1,3,25.0,75.0
37.5,4,4,0,100.0,0.0
105.66666666666667,3,3,0,100.0,0.0
30.142857142857142,7,7,0,100.0,0.0
18.470588235294116,17,15,2,88.0,12.0
37.86666666666667,30,10,20,33.0,67.0
52.24324324324324,37,13,24,35.0,65.0
31.281690140845072,71,23,48,32.0,68.0
55.81818181818182,110,25,85,23.0,77.0
41.74015748031496,127,22,105,17.0,83.0
43.61068702290076,131,27,104,21.0,79.0
45.04854368932039,206,46,160,22.0,78.0
29.871657754010695,187,42,145,22.0,78.0
34.58571428571429,140,31,109,22.0,78.0
28.96470588235294,85,19,66,22.0,78.0
32.75714285714286,70,18,52,26.0,74.0
29.5625,32,11,21,34.0,66.0
35.096774193548384,31,14,17,45.0,55.0
26.36,25,12,13,48.0,52.0
14.857142857142858,7,6,1,86.0,14.0
14.666666666666666,9,7,2,78.0,22.0
4.5,4,0,4,0.0,100.0
5.666666666666667,3,3,0,100.0,0.0
19.0,4,4,0,100.0,0.0
10.0,3,2,1,67.0,33.0
8.0,4,4,0,100.0,0.0
11.333333333333334,9,8,1,89.0,11.0
13.516129032258064,31,30,1,97.0,3.0
15.636363636363637,55,48,7,87.0,13.0
20.514285714285716,35,31,4,89.0,11.0
32.054054054054056,37,20,17,54.0,46.0
25.620689655172413,58,30,28,52.0,48.0
21.126984126984127,63,33,30,52.0,48.0
30.424657534246574,73,27,46,37.0,63.0
37.24285714285714,70,22,48,31.0,69.0
32.1875,80,26,54,32.0,68.0
26.263157894736842,95,47,48,49.0,51.0
41.567567567567565,148,73,75,49.0,51.0
21.561643835616437,73,33,40,45.0,55.0
21.03846153846154,52,27,25,52.0,48.0
16.4375,32,23,9,72.0,28.0
14.777777777777779,18,12,6,67.0,33.0
12.3125,32,21,11,66.0,34.0
59.0625,16,10,6,62.0,38.0
12.625,8,7,1,88.0,12.0
45.833333333333336,6,5,1,83.0,17.0
5.0,1,1,0,100.0,0.0
10.5,2,2,0,100.0,0.0
4.8,5,5,0,100.0,0.0
14.8,10,9,1,90.0,10.0
16.59259259259259,27,25,2,93.0,7.0
18.456521739130434,46,43,3,93.0,7.0
10.066666666666666,15,14,1,93.0,7.0
23.4,5,5,0,100.0,0.0
20.5,6,6,0,100.0,0.0
13.0,11,11,0,100.0,0.0
18.857142857142858,7,4,3,57.0,43.0
19.307692307692307,13,13,0,100.0,0.0
10.2,20,15,5,75.0,25.0
14.595238095238095,42,39,3,93.0,7.0
31.07843137254902,51,48,3,94.0,6.0
15.162162162162161,37,28,9,76.0,24.0
8.91304347826087,23,20,3,87.0,13.0
12.818181818181818,22,14,8,64.0,36.0
17.923076923076923,13,9,4,69.0,31.0
62.333333333333336,9,9,0,100.0,0.0
12.0,10,9,1,90.0,10.0
9.833333333333334,6,6,0,100.0,0.0
18.0,4,4,0,100.0,0.0
14.0,5,5,0,100.0,0.0
13.5,2,2,0,100.0,0.0
17.0,1,1,0,100.0,0.0
13.166666666666666,6,5,1,83.0,17.0
8.777777777777779,9,7,2,78.0,22.0
11.033333333333333,30,27,3,90.0,10.0
10.25531914893617,47,43,4,91.0,9.0
16.666666666666668,24,17,7,71.0,29.0
30.96551724137931,29,17,12,59.0,41.0
26.615384615384617,39,23,16,59.0,41.0
26.044444444444444,45,29,16,64.0,36.0
30.458333333333332,48,28,20,58.0,42.0
14.585365853658537,41,25,16,61.0,39.0
16.75609756097561,41,28,13,68.0,32.0
23.125,56,37,19,66.0,34.0
14.234567901234568,81,66,15,81.0,19.0
18.166666666666668,60,39,21,65.0,35.0
20.88095238095238,42,30,12,71.0,29.0
22.142857142857142,14,12,2,86.0,14.0
13.61111111111111,18,13,5,72.0,28.0
8.875,16,8,8,50.0,50.0
21.4,5,4,1,80.0,20.0
6.75,8,7,1,88.0,12.0
13.5,4,4,0,100.0,0.0
416.2,5,5,0,100.0,0.0
61.0,1,1,0,100.0,0.0
27.0,5,4,1,80.0,20.0
81.8,5,4,1,80.0,20.0
10.571428571428571,7,6,1,86.0,14.0
13.272727272727273,33,29,4,88.0,12.0
12.347826086956522,46,39,7,85.0,15.0
12.11111111111111,27,22,5,81.0,19.0
31.357142857142858,28,18,10,64.0,36.0
21.87878787878788,33,23,10,70.0,30.0
19.885714285714286,35,20,15,57.0,43.0
34.44444444444444,72,35,37,49.0,51.0
22.63157894736842,57,31,26,54.0,46.0
13.625,32,21,11,66.0,34.0
21.661538461538463,65,38,27,58.0,42.0
13.581395348837209,86,64,22,74.0,26.0
25.74468085106383,47,32,15,68.0,32.0
23.789473684210527,19,11,8,58.0,42.0
8.857142857142858,21,19,2,90.0,10.0
14.333333333333334,15,12,3,80.0,20.0
10.272727272727273,11,7,4,64.0,36.0
6.2,5,4,1,80.0,20.0
4.0,1,1,0,100.0,0.0
4.0,3,3,0,100.0,0.0
27.5,4,4,0,100.0,0.0
13.5,2,2,0,100.0,0.0
9.25,4,4,0,100.0,0.0
5.666666666666667,3,3,0,100.0,0.0
26.6,10,9,1,90.0,10.0
14.047619047619047,21,21,0,100.0,0.0
9.69047619047619,42,38,4,90.0,10.0
11.84,25,22,3,88.0,12.0
14.333333333333334,33,23,10,70.0,30.0
12.393939393939394,33,26,7,79.0,21.0
17.253731343283583,67,39,28,58.0,42.0
23.23076923076923,39,29,10,74.0,26.0
24.344827586206897,58,33,25,57.0,43.0
19.095238095238095,42,26,16,62.0,38.0
31.985915492957748,71,41,30,58.0,42.0
19.238805970149254,67,44,23,66.0,34.0
14.090909090909092,55,43,12,78.0,22.0
10.444444444444445,18,12,6,67.0,33.0
12.636363636363637,11,10,1,91.0,9.0
23.0,14,9,5,64.0,36.0
29.88235294117647,17,9,8,53.0,47.0
49.44444444444444,9,5,4,56.0,44.0
13.142857142857142,7,5,2,71.0,29.0
5.5,4,4,0,100.0,0.0
11.6,5,5,0,100.0,0.0
21.5,2,1,1,50.0,50.0
12.0,3,3,0,100.0,0.0
8.25,8,5,3,62.0,38.0
57.2,5,5,0,100.0,0.0
9.5625,16,12,4,75.0,25.0
26.91304347826087,23,11,12,48.0,52.0
40.5,56,20,36,36.0,64.0
62.68,50,23,27,46.0,54.0
25.50769230769231,65,29,36,45.0,55.0
21.372549019607842,51,15,36,29.0,71.0
17.77777777777778,45,21,24,47.0,53.0
22.696969696969695,33,15,18,45.0,55.0
17.12,25,12,13,48.0,52.0
37.71111111111111,45,18,27,40.0,60.0
26.185185185185187,27,12,15,44.0,56.0
10.916666666666666,12,9,3,75.0,25.0
19.736842105263158,19,5,14,26.0,74.0
10.75,24,11,13,46.0,54.0
31.166666666666668,12,8,4,67.0,33.0
19.692307692307693,13,5,8,38.0,62.0
9.875,8,5,3,62.0,38.0
10.0,4,2,2,50.0,50.0
10.0,3,3,0,100.0,0.0
59.0,3,2,1,67.0,33.0
6.333333333333333,3,3,0,100.0,0.0
21.25,4,2,2,50.0,50.0
39.0,8,1,7,12.0,88.0
34.63636363636363,11,5,6,45.0,55.0
25.40740740740741,27,15,12,56.0,44.0
14.238095238095237,21,16,5,76.0,24.0
29.13157894736842,38,14,24,37.0,63.0
30.113636363636363,44,29,15,66.0,34.0
26.579710144927535,69,27,42,39.0,61.0
31.08695652173913,69,34,35,49.0,51.0
29.71014492753623,69,27,42,39.0,61.0
85.4,50,20,30,40.0,60.0
37.490196078431374,51,23,28,45.0,55.0
26.178571428571427,56,13,43,23.0,77.0
29.12121212121212,33,13,20,39.0,61.0
32.06896551724138,29,14,15,48.0,52.0
17.23076923076923,13,8,5,62.0,38.0
26.5,12,6,6,50.0,50.0
13.714285714285714,14,10,4,71.0,29.0
24.625,8,8,0,100.0,0.0
14.5,4,3,1,75.0,25.0
47.75,4,4,0,100.0,0.0
19.333333333333332,3,3,0,100.0,0.0
44.0,1,1,0,100.0,0.0
13.75,4,3,1,75.0,25.0
11.444444444444445,9,9,0,100.0,0.0
6.3,10,8,2,80.0,20.0
9.782608695652174,23,20,3,87.0,13.0
13.175,40,34,6,85.0,15.0
9.172413793103448,29,24,5,83.0,17.0
34.666666666666664,27,17,10,63.0,37.0
28.941176470588236,34,26,8,76.0,24.0
24.810344827586206,58,35,23,60.0,40.0
24.53968253968254,63,36,27,57.0,43.0
21.70967741935484,31,20,11,65.0,35.0
22.0,64,29,35,45.0,55.0
26.2,95,52,43,55.0,45.0
29.50574712643678,87,50,37,57.0,43.0
29.28048780487805,82,42,40,51.0,49.0
31.642857142857142,56,26,30,46.0,54.0
20.096774193548388,31,17,14,55.0,45.0
14.176470588235293,17,10,7,59.0,41.0
19.076923076923077,13,10,3,77.0,23.0
24.0,12,9,3,75.0,25.0
19.5,6,5,1,83.0,17.0
7.0,1,1,0,100.0,0.0
53.0,1,1,0,100.0,0.0
2.0,1,1,0,100.0,0.0
9.4,5,5,0,100.0,0.0
40.76923076923077,13,12,1,92.0,8.0
14.2,30,24,6,80.0,20.0
9.2,45,41,4,91.0,9.0
24.77777777777778,27,20,7,74.0,26.0
15.4,25,23,2,92.0,8.0
22.0,46,23,23,50.0,50.0
25.327272727272728,55,30,25,55.0,45.0
32.61643835616438,73,28,45,38.0,62.0
41.33846153846154,65,31,34,48.0,52.0
48.8974358974359,78,38,40,49.0,51.0
24.127450980392158,102,59,43,58.0,42.0
31.26829268292683,123,78,45,63.0,37.0
19.925531914893618,94,45,49,48.0,52.0
19.379310344827587,58,33,25,57.0,43.0
18.633333333333333,30,19,11,63.0,37.0
15.548387096774194,31,20,11,65.0,35.0
13.382352941176471,34,13,21,38.0,62.0
14.2,10,3,7,30.0,70.0
31.22222222222222,9,4,5,44.0,56.0
24.5,4,4,0,100.0,0.0
54.666666666666664,3,1,2,33.0,67.0
11.166666666666666,6,6,0,100.0,0.0
4.333333333333333,3,3,0,100.0,0.0
27.647058823529413,17,16,1,94.0,6.0
10.566666666666666,30,29,1,97.0,3.0
10.216216216216216,37,32,5,86.0,14.0
21.225806451612904,31,23,8,74.0,26.0
18.29032258064516,31,22,9,71.0,29.0
19.825,40,35,5,88.0,12.0
30.17948717948718,39,34,5,87.0,13.0
27.434782608695652,23,17,6,74.0,26.0
10.863636363636363,22,18,4,82.0,18.0
21.192307692307693,26,19,7,73.0,27.0
15.916666666666666,36,28,8,78.0,22.0
12.860759493670885,79,61,18,77.0,23.0
38.666666666666664,36,27,9,75.0,25.0
17.375,32,24,8,75.0,25.0
6.857142857142857,14,12,2,86.0,14.0
26.571428571428573,7,5,2,71.0,29.0
7.0,8,7,1,88.0,12.0
13.5,4,4,0,100.0,0.0
5.5,2,2,0,100.0,0.0
3.0,2,2,0,100.0,0.0
13.5,2,2,0,100.0,0.0
36.0,1,1,0,100.0,0.0
10.333333333333334,3,2,1,67.0,33.0
7.0,1,1,0,100.0,0.0
6.5,6,6,0,100.0,0.0
13.466666666666667,15,15,0,100.0,0.0
25.391304347826086,23,22,1,96.0,4.0
20.625,8,7,1,88.0,12.0
4.6923076923076925,13,12,1,92.0,8.0
17.083333333333332,12,11,1,92.0,8.0
103.41666666666667,12,11,1,92.0,8.0
12.125,24,20,4,83.0,17.0
10.846153846153847,26,24,2,92.0,8.0
32.37931034482759,29,23,6,79.0,21.0
17.28125,32,25,7,78.0,22.0
14.835820895522389,67,49,18,73.0,27.0
20.471698113207548,53,46,7,87.0,13.0
8.4,20,18,2,90.0,10.0
16.2,5,4,1,80.0,20.0
10.222222222222221,9,9,0,100.0,0.0
6.5,6,6,0,100.0,0.0
6.0,1,1,0,100.0,0.0
2.0,1,1,0,100.0,0.0
15.0,1,1,0,100.0,0.0
9.5,2,2,0,100.0,0.0
7.833333333333333,6,6,0,100.0,0.0
13.4375,16,15,1,94.0,6.0
9.678571428571429,28,25,3,89.0,11.0
12.692307692307692,13,11,2,85.0,15.0
15.842105263157896,19,18,1,95.0,5.0
19.178571428571427,28,20,8,71.0,29.0
24.86842105263158,38,31,7,82.0,18.0
16.142857142857142,21,17,4,81.0,19.0
20.916666666666668,36,22,14,61.0,39.0
13.764705882352942,34,22,12,65.0,35.0
28.0,32,25,7,78.0,22.0
15.709677419354838,31,27,4,87.0,13.0
11.0,21,17,4,81.0,19.0
11.647058823529411,17,15,2,88.0,12.0
13.333333333333334,6,4,2,67.0,33.0
39.36363636363637,11,8,3,73.0,27.0
7.4,5,5,0,100.0,0.0
16.5,6,3,3,50.0,50.0
18.0,2,2,0,100.0,0.0
14.333333333333334,3,3,0,100.0,0.0
23.75,4,4,0,100.0,0.0
2.0,1,1,0,100.0,0.0
10.0,1,1,0,100.0,0.0
31.571428571428573,7,6,1,86.0,14.0
41.8,5,4,1,80.0,20.0
192.66666666666666,12,12,0,100.0,0.0
13.25,16,9,7,56.0,44.0
14.525,40,26,14,65.0,35.0
14.607142857142858,28,12,16,43.0,57.0
23.64516129032258,31,14,17,45.0,55.0
16.38235294117647,34,13,21,38.0,62.0
23.533333333333335,15,4,11,27.0,73.0
19.625,32,14,18,44.0,56.0
26.476190476190474,21,9,12,43.0,57.0
36.57142857142857,35,21,14,60.0,40.0
47.90625,32,20,12,62.0,38.0
21.53846153846154,13,7,6,54.0,46.0
12.944444444444445,18,13,5,72.0,28.0
11.3,10,8,2,80.0,20.0
12.272727272727273,11,4,7,36.0,64.0
11.25,8,7,1,88.0,12.0
32.0,3,2,1,67.0,33.0
8.4,5,3,2,60.0,40.0
33.75,4,2,2,50.0,50.0
21.833333333333332,6,0,6,0.0,100.0
12.0,1,0,1,0.0,100.0
3.0,1,1,0,100.0,0.0
30.2,5,4,1,80.0,20.0
11.6,5,4,1,80.0,20.0
10.11111111111111,9,8,1,89.0,11.0
26.0,15,10,5,67.0,33.0
17.36842105263158,19,12,7,63.0,37.0
26.72,25,11,14,44.0,56.0
26.280701754385966,57,19,38,33.0,67.0
40.09090909090909,33,16,17,48.0,52.0
35.423529411764704,85,19,66,22.0,78.0
29.985294117647058,68,25,43,37.0,63.0
25.979166666666668,48,16,32,33.0,67.0
27.081967213114755,61,21,40,34.0,66.0
28.577464788732396,71,31,40,44.0,56.0
15.838709677419354,31,16,15,52.0,48.0
9.473684210526315,19,16,3,84.0,16.0
35.09090909090909,11,6,5,55.0,45.0
17.647058823529413,17,7,10,41.0,59.0
29.875,16,6,10,38.0,62.0
20.5,4,2,2,50.0,50.0
4.0,1,0,1,0.0,100.0
9.166666666666666,6,5,1,83.0,17.0
12.75,8,8,0,100.0,0.0
9.833333333333334,6,4,2,67.0,33.0
12.8,20,19,1,95.0,5.0
13.128205128205128,39,30,9,77.0,23.0
8.0,20,16,4,80.0,20.0
15.5,16,14,2,88.0,12.0
36.8235294117647,17,12,5,71.0,29.0
17.857142857142858,21,11,10,52.0,48.0
26.72222222222222,36,15,21,42.0,58.0
20.06451612903226,31,13,18,42.0,58.0
19.304347826086957,23,13,10,57.0,43.0
38.212765957446805,47,26,21,55.0,45.0
13.382352941176471,68,47,21,69.0,31.0
21.71153846153846,52,29,23,56.0,44.0
57.416666666666664,24,12,12,50.0,50.0
20.214285714285715,14,7,7,50.0,50.0
12.733333333333333,15,11,4,73.0,27.0
22.307692307692307,13,8,5,62.0,38.0
15.8,15,2,13,13.0,87.0
12.75,4,4,0,100.0,0.0
16.0,2,2,0,100.0,0.0
6.666666666666667,3,1,2,33.0,67.0
54.333333333333336,3,3,0,100.0,0.0
29.5,2,2,0,100.0,0.0
10.5,6,6,0,100.0,0.0
11.333333333333334,6,5,1,83.0,17.0
10.172413793103448,29,27,2,93.0,7.0
9.945945945945946,37,33,4,89.0,11.0
14.5,16,13,3,81.0,19.0
11.25,16,14,2,88.0,12.0
70.37142857142857,35,16,19,46.0,54.0
13.454545454545455,22,16,6,73.0,27.0
22.696969696969695,33,17,16,52.0,48.0
15.35483870967742,31,20,11,65.0,35.0
21.11764705882353,51,23,28,45.0,55.0
34.05172413793103,58,36,22,62.0,38.0
22.73134328358209,67,40,27,60.0,40.0
16.759493670886076,79,57,22,72.0,28.0
9.3125,32,27,5,84.0,16.0
6.857142857142857,21,11,10,52.0,48.0
13.454545454545455,22,21,1,95.0,5.0
29.071428571428573,14,8,6,57.0,43.0
7.777777777777778,9,7,2,78.0,22.0
7.2,5,3,2,60.0,40.0
21.666666666666668,3,1,2,33.0,67.0
41.666666666666664,6,2,4,33.0,67.0
14.0,2,2,0,100.0,0.0
37.333333333333336,3,3,0,100.0,0.0
9.25,4,4,0,100.0,0.0
9.266666666666667,15,14,1,93.0,7.0
10.06060606060606,33,30,3,91.0,9.0
11.529411764705882,51,43,8,84.0,16.0
10.413793103448276,29,26,3,90.0,10.0
71.14285714285714,35,23,12,66.0,34.0
26.487179487179485,39,24,15,62.0,38.0
25.89189189189189,37,26,11,70.0,30.0
36.32,50,23,27,46.0,54.0
27.406779661016948,59,29,30,49.0,51.0
33.38461538461539,65,27,38,42.0,58.0
22.481927710843372,83,40,43,48.0,52.0
19.217821782178216,101,63,38,62.0,38.0
19.014705882352942,68,42,26,62.0,38.0
18.076923076923077,39,22,17,56.0,44.0
11.576923076923077,26,15,11,58.0,42.0
16.4375,16,11,5,69.0,31.0
11.4,10,5,5,50.0,50.0
21.6,10,7,3,70.0,30.0
10.666666666666666,3,3,0,100.0,0.0
15.0,2,1,1,50.0,50.0
5.0,1,1,0,100.0,0.0
2.0,1,1,0,100.0,0.0
17.75,4,3,1,75.0,25.0
7.4,5,5,0,100.0,0.0
8.875,8,7,1,88.0,12.0
11.090909090909092,22,18,4,82.0,18.0
13.368421052631579,57,52,5,91.0,9.0
16.18421052631579,38,25,13,66.0,34.0
24.678571428571427,28,19,9,68.0,32.0
34.851851851851855,54,19,35,35.0,65.0
29.596774193548388,62,24,38,39.0,61.0
25.85,60,21,39,35.0,65.0
27.81159420289855,69,32,37,46.0,54.0
26.071428571428573,84,32,52,38.0,62.0
28.864197530864196,81,35,46,43.0,57.0
18.7375,80,47,33,59.0,41.0
23.75,72,42,30,58.0,42.0
21.357142857142858,56,26,30,46.0,54.0
12.918367346938776,49,28,21,57.0,43.0
27.0,20,11,9,55.0,45.0
14.136363636363637,22,10,12,45.0,55.0
25.545454545454547,11,3,8,27.0,73.0
16.428571428571427,7,7,0,100.0,0.0
8.5,4,4,0,100.0,0.0
5.6,5,5,0,100.0,0.0
109.0,1,1,0,100.0,0.0
15.666666666666666,3,2,1,67.0,33.0
22.0,3,3,0,100.0,0.0
20.625,8,6,2,75.0,25.0
10.464285714285714,28,24,4,86.0,14.0
8.657894736842104,38,32,6,84.0,16.0
38.82051282051282,39,31,8,79.0,21.0
42.654545454545456,55,23,32,42.0,58.0
38.50877192982456,57,14,43,25.0,75.0
26.454545454545453,88,35,53,40.0,60.0
30.757575757575758,66,21,45,32.0,68.0
28.02061855670103,97,22,75,23.0,77.0
28.445378151260503,119,36,83,30.0,70.0
22.59,100,54,46,54.0,46.0
20.14782608695652,115,54,61,47.0,53.0
16.241935483870968,62,31,31,50.0,50.0
37.53488372093023,43,24,19,56.0,44.0
18.17241379310345,29,16,13,55.0,45.0
23.83783783783784,37,16,21,43.0,57.0
21.17391304347826,23,8,15,35.0,65.0
21.6,15,7,8,47.0,53.0
13.5,12,9,3,75.0,25.0
60.083333333333336,12,9,3,75.0,25.0
72.5,4,2,2,50.0,50.0
353.0,1,1,0,100.0,0.0
18.333333333333332,3,0,3,0.0,100.0
20.2,5,5,0,100.0,0.0
10.6,5,3,2,60.0,40.0
10.538461538461538,13,12,1,92.0,8.0
17.63157894736842,19,11,8,58.0,42.0
23.391304347826086,23,12,11,52.0,48.0
34.36486486486486,74,21,53,28.0,72.0
33.42,100,22,78,22.0,78.0
27.622222222222224,135,33,102,24.0,76.0
40.81699346405229,153,26,127,17.0,83.0
45.462025316455694,158,26,132,16.0,84.0
41.83510638297872,188,39,149,21.0,79.0
44.8562874251497,167,33,134,20.0,80.0
57.76923076923077,195,44,151,23.0,77.0
45.66935483870968,124,33,91,27.0,73.0
32.697916666666664,96,25,71,26.0,74.0
31.53191489361702,47,16,31,34.0,66.0
24.520833333333332,48,14,34,29.0,71.0
16.36842105263158,19,12,7,63.0,37.0
16.071428571428573,14,9,5,64.0,36.0
19.9,10,6,4,60.0,40.0
25.22222222222222,9,4,5,44.0,56.0
12.625,8,2,6,25.0,75.0
3.5,4,4,0,100.0,0.0
3.0,1,1,0,100.0,0.0
13.5,4,3,1,75.0,25.0
13.166666666666666,6,6,0,100.0,0.0
21.80952380952381,21,9,12,43.0,57.0
23.8,25,9,16,36.0,64.0
31.72222222222222,18,9,9,50.0,50.0
18.791666666666668,24,12,12,50.0,50.0
20.033333333333335,30,14,16,47.0,53.0
40.18181818181818,33,16,17,48.0,52.0
19.76,25,12,13,48.0,52.0
10.818181818181818,22,16,6,73.0,27.0
15.571428571428571,14,5,9,36.0,64.0
14.0,10,6,4,60.0,40.0
35.916666666666664,12,7,5,58.0,42.0
9.714285714285714,7,4,3,57.0,43.0
10.9,10,7,3,70.0,30.0
23.6,10,9,1,90.0,10.0
17.5,8,7,1,88.0,12.0
22.5,4,3,1,75.0,25.0
6.75,4,3,1,75.0,25.0
27.0,4,2,2,50.0,50.0
660.0,1,1,0,100.0,0.0
9.0,1,1,0,100.0,0.0
9.666666666666666,3,3,0,100.0,0.0
7.333333333333333,6,6,0,100.0,0.0
12.88888888888889,9,7,2,78.0,22.0
9.68,25,22,3,88.0,12.0
43.44186046511628,43,35,8,81.0,19.0
21.0,37,20,17,54.0,46.0
26.75,32,18,14,56.0,44.0
27.78,50,29,21,58.0,42.0
26.75,44,35,9,80.0,20.0
28.347826086956523,46,25,21,54.0,46.0
22.65625,32,21,11,66.0,34.0
27.56756756756757,37,20,17,54.0,46.0
20.053571428571427,56,37,19,66.0,34.0
16.986301369863014,73,58,15,79.0,21.0
13.075757575757576,66,42,24,64.0,36.0
11.057142857142857,35,25,10,71.0,29.0
20.166666666666668,24,15,9,62.0,38.0
11.25,20,14,6,70.0,30.0
19.90909090909091,11,10,1,91.0,9.0
14.75,8,7,1,88.0,12.0
38.0,8,7,1,88.0,12.0
11.5,4,4,0,100.0,0.0
569.0,2,2,0,100.0,0.0
25.0,1,1,0,100.0,0.0
9.0,3,3,0,100.0,0.0
49.75,4,4,0,100.0,0.0
7.454545454545454,11,10,1,91.0,9.0
9.6875,32,30,2,94.0,6.0
10.69047619047619,42,38,4,90.0,10.0
17.896551724137932,29,21,8,72.0,28.0
18.6875,16,10,6,62.0,38.0
16.127659574468087,47,33,14,70.0,30.0
19.75925925925926,54,31,23,57.0,43.0
18.818181818181817,33,17,16,52.0,48.0
26.060606060606062,33,20,13,61.0,39.0
22.575,40,26,14,65.0,35.0
21.821428571428573,56,38,18,68.0,32.0
13.435294117647059,85,66,19,78.0,22.0
12.044444444444444,45,30,15,67.0,33.0
12.709677419354838,31,28,3,90.0,10.0
15.478260869565217,23,18,5,78.0,22.0
24.19047619047619,21,15,6,71.0,29.0
25.23076923076923,13,12,1,92.0,8.0
9.5,8,6,2,75.0,25.0
26.0,4,3,1,75.0,25.0
88.66666666666667,3,3,0,100.0,0.0
8.0,1,1,0,100.0,0.0
10.0,1,1,0,100.0,0.0
9.0,4,4,0,100.0,0.0
8.833333333333334,6,6,0,100.0,0.0
19.9,10,10,0,100.0,0.0
16.571428571428573,28,25,3,89.0,11.0
8.6,45,40,5,89.0,11.0
13.608695652173912,23,17,6,74.0,26.0
11.095238095238095,21,20,1,95.0,5.0
11.916666666666666,36,24,12,67.0,33.0
14.717948717948717,39,32,7,82.0,18.0
27.6046511627907,43,26,17,60.0,40.0
20.53488372093023,43,25,18,58.0,42.0
27.34285714285714,35,26,9,74.0,26.0
22.34328358208955,67,45,22,67.0,33.0
13.507042253521126,71,54,17,76.0,24.0
18.862068965517242,58,43,15,74.0,26.0
13.488372093023257,43,31,12,72.0,28.0
10.68421052631579,19,16,3,84.0,16.0
13.142857142857142,14,12,2,86.0,14.0
18.88235294117647,17,12,5,71.0,29.0
6.25,4,3,1,75.0,25.0
26.166666666666668,6,1,5,17.0,83.0
23.0,4,2,2,50.0,50.0
16.666666666666668,3,3,0,100.0,0.0
19.0,4,4,0,100.0,0.0
33.888888888888886,9,9,0,100.0,0.0
8.904761904761905,21,20,1,95.0,5.0
10.333333333333334,42,38,4,90.0,10.0
20.44,25,18,7,72.0,28.0
9.666666666666666,3,3,0,100.0,0.0
21.466666666666665,15,14,1,93.0,7.0
11.23076923076923,26,23,3,88.0,12.0
13.45,20,17,3,85.0,15.0
16.615384615384617,13,12,1,92.0,8.0
32.03846153846154,26,19,7,73.0,27.0
14.76923076923077,26,21,5,81.0,19.0
12.779661016949152,59,52,7,88.0,12.0
13.685714285714285,35,29,6,83.0,17.0
30.88888888888889,18,12,6,67.0,33.0
40.833333333333336,12,10,2,83.0,17.0
9.692307692307692,13,8,5,62.0,38.0
10.461538461538462,13,10,3,77.0,23.0
11.272727272727273,11,8,3,73.0,27.0
3.0,2,2,0,100.0,0.0
110.0,2,2,0,100.0,0.0
15.0,1,1,0,100.0,0.0
41.8,5,5,0,100.0,0.0
4.0,1,1,0,100.0,0.0
6.0,3,3,0,100.0,0.0
7.9,10,6,4,60.0,40.0
18.928571428571427,28,26,2,93.0,7.0
13.0625,32,29,3,91.0,9.0
9.761904761904763,21,17,4,81.0,19.0
69.13333333333334,30,13,17,43.0,57.0
27.166666666666668,42,29,13,69.0,31.0
18.181818181818183,33,24,9,73.0,27.0
27.448979591836736,49,22,27,45.0,55.0
19.661016949152543,59,37,22,63.0,37.0
25.74074074074074,81,39,42,48.0,52.0
24.522727272727273,88,50,38,57.0,43.0
21.34108527131783,129,70,59,54.0,46.0
26.72043010752688,93,35,58,38.0,62.0
28.625,64,26,38,41.0,59.0
30.513513513513512,37,14,23,38.0,62.0
37.05555555555556,36,16,20,44.0,56.0
28.81132075471698,53,24,29,45.0,55.0
23.565217391304348,23,14,9,61.0,39.0
19.4,15,9,6,60.0,40.0
18.5,8,6,2,75.0,25.0
11.0,1,1,0,100.0,0.0
25.0,1,1,0,100.0,0.0
25.0,1,1,0,100.0,0.0
25.166666666666668,6,5,1,83.0,17.0
28.571428571428573,7,3,4,43.0,57.0
43.095238095238095,21,15,6,71.0,29.0
54.52173913043478,23,13,10,57.0,43.0
21.125,48,21,27,44.0,56.0
26.9375,64,18,46,28.0,72.0
24.232558139534884,43,15,28,35.0,65.0
28.333333333333332,48,8,40,17.0,83.0
30.96153846153846,26,8,18,31.0,69.0
19.693877551020407,49,12,37,24.0,76.0
20.44,25,10,15,40.0,60.0
24.625,8,4,4,50.0,50.0
30.875,8,5,3,62.0,38.0
13.833333333333334,6,4,2,67.0,33.0
14.0,4,4,0,100.0,0.0
17.09090909090909,11,10,1,91.0,9.0
7.333333333333333,6,3,3,50.0,50.0
14.333333333333334,3,2,1,67.0,33.0
4.666666666666667,3,3,0,100.0,0.0
124.0,1,1,0,100.0,0.0
8.0,1,1,0,100.0,0.0
26.0,2,2,0,100.0,0.0
41.166666666666664,6,5,1,83.0,17.0
44.5,2,2,0,100.0,0.0
16.5,4,4,0,100.0,0.0
23.25,4,3,1,75.0,25.0
31.25,8,7,1,88.0,12.0
30.692307692307693,26,17,9,65.0,35.0
34.26470588235294,34,26,8,76.0,24.0
36.65384615384615,26,13,13,50.0,50.0
22.2,25,12,13,48.0,52.0
18.548387096774192,31,20,11,65.0,35.0
17.5,34,23,11,68.0,32.0
24.48076923076923,52,27,25,52.0,48.0
21.342105263157894,38,17,21,45.0,55.0
20.9,30,16,14,53.0,47.0
20.071428571428573,14,6,8,43.0,57.0
15.8125,16,10,6,62.0,38.0
148.0,18,15,3,83.0,17.0
49.0,2,2,0,100.0,0.0
69.25,4,2,2,50.0,50.0
215.25,4,4,0,100.0,0.0
198.0,1,1,0,100.0,0.0
15.0,4,3,1,75.0,25.0
10.4,10,10,0,100.0,0.0
5.5,6,6,0,100.0,0.0
14.74074074074074,27,27,0,100.0,0.0
13.76595744680851,47,42,5,89.0,11.0
17.357142857142858,28,23,5,82.0,18.0
27.083333333333332,24,15,9,62.0,38.0
42.17142857142857,35,23,12,66.0,34.0
46.067796610169495,59,35,24,59.0,41.0
24.956521739130434,46,31,15,67.0,33.0
25.886363636363637,44,22,22,50.0,50.0
25.56896551724138,58,31,27,53.0,47.0
18.987951807228917,83,51,32,61.0,39.0
59.11009174311926,109,68,41,62.0,38.0
32.36046511627907,86,48,38,56.0,44.0
20.21818181818182,55,24,31,44.0,56.0
11.916666666666666,48,32,16,67.0,33.0
20.842105263157894,38,21,17,55.0,45.0
71.66666666666667,15,11,4,73.0,27.0
32.0,19,7,12,37.0,63.0
16.0,7,6,1,86.0,14.0
33.666666666666664,3,3,0,100.0,0.0
22.0,1,1,0,100.0,0.0
2.0,1,1,0,100.0,0.0
6.5,2,2,0,100.0,0.0
7.4,5,5,0,100.0,0.0
7.0,12,10,2,83.0,17.0
14.176470588235293,17,16,1,94.0,6.0
10.083333333333334,24,24,0,100.0,0.0
15.307692307692308,13,12,1,92.0,8.0
24.4,15,14,1,93.0,7.0
15.928571428571429,28,24,4,86.0,14.0
12.181818181818182,22,17,5,77.0,23.0
17.681818181818183,22,15,7,68.0,32.0
11.65625,32,27,5,84.0,16.0
12.81578947368421,38,29,9,76.0,24.0
13.40677966101695,59,53,6,90.0,10.0
16.307692307692307,91,68,23,75.0,25.0
15.058823529411764,51,37,14,73.0,27.0
13.447368421052632,38,26,12,68.0,32.0
14.655172413793103,29,23,6,79.0,21.0
13.863636363636363,22,16,6,73.0,27.0
17.466666666666665,15,9,6,60.0,40.0
3.25,4,3,1,75.0,25.0
21.333333333333332,6,2,4,33.0,67.0
35.0,2,1,1,50.0,50.0
42.166666666666664,6,6,0,100.0,0.0
42.0,2,1,1,50.0,50.0
35.5,2,2,0,100.0,0.0
8.6,5,3,2,60.0,40.0
7.470588235294118,17,15,2,88.0,12.0
9.222222222222221,27,21,6,78.0,22.0
9.244897959183673,49,43,6,88.0,12.0
13.125,24,21,3,88.0,12.0
18.625,16,13,3,81.0,19.0
12.407407407407407,27,24,3,89.0,11.0
25.20689655172414,29,25,4,86.0,14.0
10.892857142857142,28,22,6,79.0,21.0
14.058823529411764,34,25,9,74.0,26.0
11.875,32,23,9,72.0,28.0
12.62962962962963,27,19,8,70.0,30.0
15.264705882352942,34,28,6,82.0,18.0
14.384615384615385,26,20,6,77.0,23.0
8.5,12,10,2,83.0,17.0
7.777777777777778,9,8,1,89.0,11.0
11.444444444444445,9,8,1,89.0,11.0
10.1,10,9,1,90.0,10.0
8.0,3,3,0,100.0,0.0
4.333333333333333,3,3,0,100.0,0.0
6.666666666666667,3,3,0,100.0,0.0
3.0,1,1,0,100.0,0.0
8.5,2,1,1,50.0,50.0
8.333333333333334,3,3,0,100.0,0.0
7.888888888888889,9,7,2,78.0,22.0
11.368421052631579,19,19,0,100.0,0.0
11.612903225806452,31,27,4,87.0,13.0
10.875,16,14,2,88.0,12.0
14.235294117647058,17,12,5,71.0,29.0
158.42105263157896,19,15,4,79.0,21.0
11.333333333333334,24,18,6,75.0,25.0
11.19047619047619,21,18,3,86.0,14.0
13.238095238095237,21,17,4,81.0,19.0
15.411764705882353,34,29,5,85.0,15.0
18.783783783783782,37,30,7,81.0,19.0
14.10344827586207,58,50,8,86.0,14.0
14.217391304347826,46,41,5,89.0,11.0
17.107142857142858,28,19,9,68.0,32.0
12.833333333333334,18,13,5,72.0,28.0
14.090909090909092,22,16,6,73.0,27.0
23.733333333333334,15,9,6,60.0,40.0
11.166666666666666,6,3,3,50.0,50.0
10.777777777777779,9,7,2,78.0,22.0
22.0,2,2,0,100.0,0.0
6.5,2,1,1,50.0,50.0
16.0,1,1,0,100.0,0.0
10.5,2,2,0,100.0,0.0
4.6,5,5,0,100.0,0.0
11.0,9,9,0,100.0,0.0
10.714285714285714,21,21,0,100.0,0.0
12.612903225806452,31,25,6,81.0,19.0
9.0,18,16,2,89.0,11.0
33.0,13,9,4,69.0,31.0
94.81818181818181,22,19,3,86.0,14.0
23.825,40,30,10,75.0,25.0
21.975,40,27,13,68.0,32.0
15.340425531914894,47,27,20,57.0,43.0
14.953488372093023,43,34,9,79.0,21.0
21.30188679245283,53,35,18,66.0,34.0
17.764705882352942,68,48,20,71.0,29.0
17.278688524590162,61,36,25,59.0,41.0
12.67741935483871,31,26,5,84.0,16.0
17.157894736842106,19,16,3,84.0,16.0
7.6875,16,16,0,100.0,0.0
17.692307692307693,13,10,3,77.0,23.0
13.5,18,11,7,61.0,39.0
9.222222222222221,9,5,4,56.0,44.0
21.133333333333333,15,7,8,47.0,53.0
21.25,8,5,3,62.0,38.0
12.0,1,0,1,0.0,100.0
8.75,4,3,1,75.0,25.0
11.0,6,3,3,50.0,50.0
18.75,4,3,1,75.0,25.0
9.695652173913043,23,18,5,78.0,22.0
34.34615384615385,26,19,7,73.0,27.0
22.473684210526315,38,18,20,47.0,53.0
25.2,55,16,39,29.0,71.0
39.8235294117647,68,25,43,37.0,63.0
30.393617021276597,94,29,65,31.0,69.0
28.012048192771083,83,19,64,23.0,77.0
25.4,65,13,52,20.0,80.0
25.23404255319149,47,13,34,28.0,72.0
14.088235294117647,34,19,15,56.0,44.0
22.62857142857143,35,18,17,51.0,49.0
12.090909090909092,22,10,12,45.0,55.0
11.157894736842104,19,12,7,63.0,37.0
10.764705882352942,17,15,2,88.0,12.0
28.0,12,9,3,75.0,25.0
32.6,5,3,2,60.0,40.0
10.0,2,2,0,100.0,0.0
8.0,4,4,0,100.0,0.0
7.5,2,2,0,100.0,0.0
15.25,4,4,0,100.0,0.0
94.5,2,2,0,100.0,0.0
6.6,5,4,1,80.0,20.0
19.333333333333332,6,4,2,67.0,33.0
11.23076923076923,13,11,2,85.0,15.0
34.166666666666664,18,8,10,44.0,56.0
32.63636363636363,11,8,3,73.0,27.0
19.291666666666668,24,17,7,71.0,29.0
15.933333333333334,15,10,5,67.0,33.0
17.444444444444443,9,9,0,100.0,0.0
6.2,5,3,2,60.0,40.0
12.333333333333334,12,8,4,67.0,33.0
12.11111111111111,9,6,3,67.0,33.0
25.90909090909091,22,18,4,82.0,18.0
17.27777777777778,18,17,1,94.0,6.0
6.375,8,6,2,75.0,25.0
12.714285714285714,14,10,4,71.0,29.0
13.2,10,8,2,80.0,20.0
6.428571428571429,7,6,1,86.0,14.0
3.0,1,1,0,100.0,0.0
35.0,1,1,0,100.0,0.0
34.0,1,1,0,100.0,0.0
7.0,1,1,0,100.0,0.0
5.5,4,4,0,100.0,0.0
33.27272727272727,11,10,1,91.0,9.0
12.772727272727273,22,21,1,95.0,5.0
9.166666666666666,24,23,1,96.0,4.0
23.5,14,10,4,71.0,29.0
17.9375,16,12,4,75.0,25.0
9.32,25,24,1,96.0,4.0
17.875,32,28,4,88.0,12.0
54.42857142857143,28,23,5,82.0,18.0
32.0,17,12,5,71.0,29.0
12.08695652173913,23,20,3,87.0,13.0
13.875,24,21,3,88.0,12.0
10.421052631578947,38,36,2,95.0,5.0
15.72972972972973,37,29,8,78.0,22.0
15.285714285714286,21,18,3,86.0,14.0
12.789473684210526,19,15,4,79.0,21.0
8.333333333333334,12,9,3,75.0,25.0
9.4,10,7,3,70.0,30.0
6.0,2,2,0,100.0,0.0
23.142857142857142,7,6,1,86.0,14.0
4.0,2,2,0,100.0,0.0
12.0,2,2,0,100.0,0.0
13.333333333333334,3,3,0,100.0,0.0
10.0,3,3,0,100.0,0.0
8.923076923076923,13,12,1,92.0,8.0
11.78125,32,26,6,81.0,19.0
22.906976744186046,43,37,6,86.0,14.0
10.466666666666667,30,22,8,73.0,27.0
26.928571428571427,14,11,3,79.0,21.0
11.91891891891892,37,24,13,65.0,35.0
14.875,32,22,10,69.0,31.0
16.96969696969697,33,26,7,79.0,21.0
20.916666666666668,36,25,11,69.0,31.0
22.130434782608695,46,28,18,61.0,39.0
20.442622950819672,61,46,15,75.0,25.0
20.17241379310345,87,74,13,85.0,15.0
13.51923076923077,52,43,9,83.0,17.0
17.607142857142858,28,24,4,86.0,14.0
47.0,33,21,12,64.0,36.0
23.32,25,17,8,68.0,32.0
7.380952380952381,21,19,2,90.0,10.0
5.333333333333333,3,3,0,100.0,0.0
44.714285714285715,7,7,0,100.0,0.0
7.4,5,5,0,100.0,0.0
14.0,2,1,1,50.0,50.0
79.5,2,2,0,100.0,0.0
8.0,3,3,0,100.0,0.0
17.363636363636363,11,9,2,82.0,18.0
9.297297297297296,37,33,4,89.0,11.0
11.333333333333334,45,42,3,93.0,7.0
11.868421052631579,38,31,7,82.0,18.0
27.56,25,20,5,80.0,20.0
15.242424242424242,33,25,8,76.0,24.0
14.5,48,37,11,77.0,23.0
21.634146341463413,41,33,8,80.0,20.0
23.25531914893617,47,27,20,57.0,43.0
16.5531914893617,47,34,13,72.0,28.0
17.31578947368421,57,44,13,77.0,23.0
14.020408163265307,98,79,19,81.0,19.0
20.182795698924732,93,59,34,63.0,37.0
17.88235294117647,34,30,4,88.0,12.0
12.642857142857142,28,17,11,61.0,39.0
24.727272727272727,11,9,2,82.0,18.0
19.625,8,5,3,62.0,38.0
24.571428571428573,7,7,0,100.0,0.0
24.857142857142858,7,4,3,57.0,43.0
17.0,2,2,0,100.0,0.0
13.0,4,4,0,100.0,0.0
12.75,4,3,1,75.0,25.0
9.7,10,7,3,70.0,30.0
17.53488372093023,43,36,7,84.0,16.0
16.2,65,51,14,78.0,22.0
17.40625,32,24,8,75.0,25.0
23.36111111111111,36,25,11,69.0,31.0
52.425925925925924,54,34,20,63.0,37.0
26.129032258064516,62,40,22,65.0,35.0
23.338028169014084,71,41,30,58.0,42.0
23.086206896551722,58,36,22,62.0,38.0
21.584615384615386,65,34,31,52.0,48.0
20.06930693069307,101,64,37,63.0,37.0
22.367924528301888,106,67,39,63.0,37.0
28.693877551020407,98,59,39,60.0,40.0
38.74576271186441,59,36,23,61.0,39.0
24.3125,32,20,12,62.0,38.0
12.636363636363637,22,15,7,68.0,32.0
18.105263157894736,19,10,9,53.0,47.0
16.533333333333335,15,4,11,27.0,73.0
4.0,4,3,1,75.0,25.0
10.2,5,2,3,40.0,60.0
13.0,2,2,0,100.0,0.0
3.0,1,1,0,100.0,0.0
7.571428571428571,7,5,2,71.0,29.0
16.38,50,43,7,86.0,14.0
11.453125,64,50,14,78.0,22.0
15.794871794871796,39,30,9,77.0,23.0
37.48148148148148,27,13,14,48.0,52.0
27.12280701754386,57,25,32,44.0,56.0
23.80952380952381,63,29,34,46.0,54.0
30.785714285714285,84,33,51,39.0,61.0
23.89189189189189,74,40,34,54.0,46.0
28.55223880597015,67,33,34,49.0,51.0
34.41904761904762,105,54,51,51.0,49.0
29.208,125,70,55,56.0,44.0
27.591397849462364,93,54,39,58.0,42.0
20.765625,64,36,28,56.0,44.0
23.473684210526315,38,14,24,37.0,63.0
17.023809523809526,42,15,27,36.0,64.0
35.44444444444444,18,11,7,61.0,39.0
17.0,19,13,6,68.0,32.0
28.352941176470587,17,6,11,35.0,65.0
11.0,8,4,4,50.0,50.0
22.75,4,1,3,25.0,75.0
5.75,4,4,0,100.0,0.0
1113.0,1,0,1,0.0,100.0
18.0,2,2,0,100.0,0.0
8.0,3,2,1,67.0,33.0
6.5,2,1,1,50.0,50.0
21.692307692307693,26,22,4,85.0,15.0
18.25,32,17,15,53.0,47.0
29.5,54,22,32,41.0,59.0
34.881889763779526,127,29,98,23.0,77.0
35.634328358208954,134,40,94,30.0,70.0
43.69318181818182,176,36,140,20.0,80.0
30.923857868020306,197,35,162,18.0,82.0
28.73913043478261,138,23,115,17.0,83.0
38.568627450980394,153,33,120,22.0,78.0
39.01360544217687,147,38,109,26.0,74.0
26.178861788617887,123,35,88,28.0,72.0
30.289156626506024,83,21,62,25.0,75.0
55.52054794520548,73,19,54,26.0,74.0
22.70967741935484,31,9,22,29.0,71.0
21.526315789473685,19,4,15,21.0,79.0
15.210526315789474,19,5,14,26.0,74.0
25.166666666666668,6,3,3,50.0,50.0
3.5,2,1,1,50.0,50.0
71.4,5,0,5,0.0,100.0
6.0,1,1,0,100.0,0.0
40.0,1,0,1,0.0,100.0
48.5,4,3,1,75.0,25.0
25.125,8,6,2,75.0,25.0
11.4,20,13,7,65.0,35.0
21.166666666666668,48,23,25,48.0,52.0
26.231884057971016,69,25,44,36.0,64.0
38.74,100,42,58,42.0,58.0
28.936507936507937,126,43,83,34.0,66.0
53.86923076923077,130,30,100,23.0,77.0
33.76047904191617,167,58,109,35.0,65.0
37.06944444444444,144,32,112,22.0,78.0
52.23076923076923,143,27,116,19.0,81.0
23.359375,128,47,81,37.0,63.0
19.310344827586206,87,45,42,52.0,48.0
40.752941176470586,85,35,50,41.0,59.0
18.625,48,27,21,56.0,44.0
16.529411764705884,17,7,10,41.0,59.0
40.714285714285715,14,7,7,50.0,50.0
11.0,6,5,1,83.0,17.0
40.8,10,3,7,30.0,70.0
8.666666666666666,3,3,0,100.0,0.0
2.5,2,2,0,100.0,0.0
22.0,1,1,0,100.0,0.0
11.333333333333334,6,5,1,83.0,17.0
25.6,10,7,3,70.0,30.0
10.666666666666666,39,35,4,90.0,10.0
14.293103448275861,58,46,12,79.0,21.0
29.92,25,15,10,60.0,40.0
23.86111111111111,36,18,18,50.0,50.0
23.72222222222222,54,30,24,56.0,44.0
23.743243243243242,74,43,31,58.0,42.0
27.223880597014926,67,32,35,48.0,52.0
29.463768115942027,69,24,45,35.0,65.0
27.627118644067796,59,32,27,54.0,46.0
21.161290322580644,93,47,46,51.0,49.0
23.02238805970149,134,79,55,59.0,41.0
20.733333333333334,105,64,41,61.0,39.0
29.52,75,37,38,49.0,51.0
128.54054054054055,37,13,24,35.0,65.0
21.681818181818183,22,17,5,77.0,23.0
13.08695652173913,23,14,9,61.0,39.0
5.428571428571429,7,3,4,43.0,57.0
17.0,5,5,0,100.0,0.0
21.8,5,1,4,20.0,80.0
31.0,1,1,0,100.0,0.0
4.5,2,2,0,100.0,0.0
9.8,5,4,1,80.0,20.0
13.363636363636363,11,10,1,91.0,9.0
13.894736842105264,57,53,4,93.0,7.0
26.258064516129032,31,28,3,90.0,10.0
20.458333333333332,24,16,8,67.0,33.0
20.185185185185187,27,12,15,44.0,56.0
15.709677419354838,62,38,24,61.0,39.0
33.333333333333336,69,28,41,41.0,59.0
20.914285714285715,70,45,25,64.0,36.0
30.53030303030303,66,31,35,47.0,53.0
20.039473684210527,76,47,29,62.0,38.0
26.697674418604652,86,43,43,50.0,50.0
21.321739130434782,115,73,42,63.0,37.0
27.184,125,65,60,52.0,48.0
35.411764705882355,85,40,45,47.0,53.0
24.703703703703702,54,29,25,54.0,46.0
33.5,40,23,17,57.0,42.0
15.26086956521739,23,9,14,39.0,61.0
25.0,15,6,9,40.0,60.0
15.666666666666666,3,2,1,67.0,33.0
7.5,2,2,0,100.0,0.0
15.0,1,1,0,100.0,0.0
36.4,5,5,0,100.0,0.0
7.0,1,1,0,100.0,0.0
17.375,8,6,2,75.0,25.0
20.055555555555557,18,17,1,94.0,6.0
14.827586206896552,58,47,11,81.0,19.0
16.92207792207792,77,62,15,81.0,19.0
18.57894736842105,38,27,11,71.0,29.0
22.472727272727273,55,24,31,44.0,56.0
25.596153846153847,52,30,22,58.0,42.0
22.854166666666668,96,54,42,56.0,44.0
31.26923076923077,52,23,29,44.0,56.0
23.622448979591837,98,41,57,42.0,58.0
20.164556962025316,79,36,43,46.0,54.0
25.722772277227723,101,56,45,55.0,45.0
24.0,152,88,64,58.0,42.0
23.5390625,128,69,59,54.0,46.0
29.807339449541285,109,41,68,38.0,62.0
24.74137931034483,58,22,36,38.0,62.0
12.71111111111111,45,16,29,36.0,64.0
27.322580645161292,31,11,20,35.0,65.0
18.80952380952381,21,8,13,38.0,62.0
25.0,7,5,2,71.0,29.0
29.2,10,6,4,60.0,40.0
9.5,2,2,0,100.0,0.0
18.666666666666668,3,3,0,100.0,0.0
8.0,3,2,1,67.0,33.0
8.5,6,6,0,100.0,0.0
9.090909090909092,11,9,2,82.0,18.0
11.131578947368421,38,34,4,89.0,11.0
11.214285714285714,70,57,13,81.0,19.0
15.86,50,35,15,70.0,30.0
18.772727272727273,44,21,23,48.0,52.0
26.50877192982456,57,38,19,67.0,33.0
27.94047619047619,84,46,38,55.0,45.0
31.297619047619047,84,34,50,40.0,60.0
34.671052631578945,76,22,54,29.0,71.0
45.329896907216494,97,40,57,41.0,59.0
27.790697674418606,129,64,65,50.0,50.0
19.575221238938052,113,60,53,53.0,47.0
26.339805825242717,103,49,54,48.0,52.0
30.76923076923077,117,53,64,45.0,55.0
24.34285714285714,70,30,40,43.0,57.0
21.319148936170212,47,22,25,47.0,53.0
19.78125,32,13,19,41.0,59.0
21.0,16,8,8,50.0,50.0
8.0,6,6,0,100.0,0.0
11.666666666666666,3,3,0,100.0,0.0
9.333333333333334,3,0,3,0.0,100.0
4.0,1,1,0,100.0,0.0
24.0,3,3,0,100.0,0.0
28.0,5,4,1,80.0,20.0
8.166666666666666,12,12,0,100.0,0.0
7.534883720930233,43,37,6,86.0,14.0
11.92,50,36,14,72.0,28.0
20.238095238095237,42,30,12,71.0,29.0
14.89655172413793,29,11,18,38.0,62.0
19.0,42,20,22,48.0,52.0
25.47761194029851,67,34,33,51.0,49.0
15.125,56,34,22,61.0,39.0
16.951219512195124,41,22,19,54.0,46.0
17.5,42,19,23,45.0,55.0
14.642857142857142,28,16,12,57.0,43.0
11.191489361702128,47,42,5,89.0,11.0
17.428571428571427,28,21,7,75.0,25.0
12.852941176470589,34,20,14,59.0,41.0
10.052631578947368,19,13,6,68.0,32.0
12.476190476190476,21,11,10,52.0,48.0
13.818181818181818,11,9,2,82.0,18.0
23.642857142857142,14,8,6,57.0,43.0
47.90909090909091,11,3,8,27.0,73.0
11.9,10,6,4,60.0,40.0
4.0,7,6,1,86.0,14.0
19.0,2,1,1,50.0,50.0
198.5,4,2,2,50.0,50.0
155.0,2,0,2,0.0,100.0
24.2,5,2,3,40.0,60.0
71.81818181818181,11,7,4,64.0,36.0
37.0,23,14,9,61.0,39.0
17.676470588235293,34,15,19,44.0,56.0
19.70149253731343,67,24,43,36.0,64.0
24.961038961038962,77,29,48,38.0,62.0
27.571428571428573,112,27,85,24.0,76.0
22.70940170940171,117,25,92,21.0,79.0
21.78,100,34,66,34.0,66.0
20.45736434108527,129,48,81,37.0,63.0
31.989247311827956,93,22,71,24.0,76.0
18.57831325301205,83,30,53,36.0,64.0
20.566666666666666,30,8,22,27.0,73.0
18.655172413793103,29,9,20,31.0,69.0
15.857142857142858,7,6,1,86.0,14.0
36.13333333333333,15,11,4,73.0,27.0
11.666666666666666,6,3,3,50.0,50.0
6.333333333333333,3,3,0,100.0,0.0
21.0,2,2,0,100.0,0.0
6.916666666666667,12,10,2,83.0,17.0
2.0,1,1,0,100.0,0.0
23.5,2,2,0,100.0,0.0
19.5,2,2,0,100.0,0.0
7.375,8,7,1,88.0,12.0
19.77777777777778,9,5,4,56.0,44.0
14.166666666666666,18,11,7,61.0,39.0
18.84375,32,21,11,66.0,34.0
30.2,35,15,20,43.0,57.0
27.829787234042552,47,15,32,32.0,68.0
30.704545454545453,44,15,29,34.0,66.0
22.357142857142858,28,15,13,54.0,46.0
28.40740740740741,27,9,18,33.0,67.0
18.361702127659573,47,23,24,49.0,51.0
22.41176470588235,34,16,18,47.0,53.0
15.95,20,15,5,75.0,25.0
25.21212121212121,33,15,18,45.0,55.0
13.333333333333334,18,11,7,61.0,39.0
37.583333333333336,12,2,10,17.0,83.0
30.083333333333332,12,5,7,42.0,58.0
28.0,11,5,6,45.0,55.0
7.0,4,4,0,100.0,0.0
18.285714285714285,7,6,1,86.0,14.0
9.0,1,1,0,100.0,0.0
16.666666666666668,3,3,0,100.0,0.0
12.0,1,1,0,100.0,0.0
19.625,8,7,1,88.0,12.0
9.0,9,8,1,89.0,11.0
11.13888888888889,36,31,5,86.0,14.0
15.05,40,37,3,92.0,8.0
12.217391304347826,23,14,9,61.0,39.0
26.884615384615383,26,14,12,54.0,46.0
22.67391304347826,46,30,16,65.0,35.0
16.5625,32,22,10,69.0,31.0
34.65853658536585,41,25,16,61.0,39.0
15.8,25,16,9,64.0,36.0
20.236842105263158,38,23,15,61.0,39.0
15.946428571428571,56,39,17,70.0,30.0
13.727272727272727,77,60,17,78.0,22.0
15.283582089552239,67,38,29,57.0,43.0
16.5,40,28,12,70.0,30.0
15.714285714285714,21,10,11,48.0,52.0
12.833333333333334,24,13,11,54.0,46.0
35.1,20,14,6,70.0,30.0
12.363636363636363,11,9,2,82.0,18.0
28.285714285714285,7,5,2,71.0,29.0
3.8333333333333335,6,6,0,100.0,0.0
13.0,1,1,0,100.0,0.0
26.428571428571427,7,5,2,71.0,29.0
13.5,6,5,1,83.0,17.0
120.10526315789474,19,18,1,95.0,5.0
23.033333333333335,30,22,8,73.0,27.0
16.814285714285713,70,53,17,76.0,24.0
25.693877551020407,49,31,18,63.0,37.0
15.205128205128204,39,26,13,67.0,33.0
16.387096774193548,62,33,29,53.0,47.0
16.614285714285714,70,30,40,43.0,57.0
15.580645161290322,62,37,25,60.0,40.0
22.03921568627451,51,28,23,55.0,45.0
20.91764705882353,85,35,50,41.0,59.0
18.474358974358974,78,35,43,45.0,55.0
51.194244604316545,139,78,61,56.0,44.0
19.256410256410255,117,57,60,49.0,51.0
19.03846153846154,52,25,27,48.0,52.0
27.70731707317073,41,25,16,61.0,39.0
10.342105263157896,38,29,9,76.0,24.0
18.166666666666668,18,13,5,72.0,28.0
20.863636363636363,22,9,13,41.0,59.0
4.0,2,2,0,100.0,0.0
7.4,5,5,0,100.0,0.0
28.5,2,1,1,50.0,50.0
10.0,4,1,3,25.0,75.0
8.666666666666666,6,5,1,83.0,17.0
7.125,8,6,2,75.0,25.0
21.916666666666668,12,9,3,75.0,25.0
11.365853658536585,82,54,28,66.0,34.0
13.070707070707071,99,53,46,54.0,46.0
19.515625,64,32,32,50.0,50.0
20.72,50,19,31,38.0,62.0
18.347368421052632,95,41,54,43.0,57.0
28.76,125,55,70,44.0,56.0
23.10891089108911,101,32,69,32.0,68.0
37.924731182795696,93,32,61,34.0,66.0
22.8,105,32,73,30.0,70.0
20.81875,160,71,89,44.0,56.0
22.796019900497512,201,75,126,37.0,63.0
30.61139896373057,193,60,133,31.0,69.0
23.34931506849315,146,44,102,30.0,70.0
29.8015873015873,126,34,92,27.0,73.0
28.567010309278352,97,29,68,30.0,70.0
19.928571428571427,28,11,17,39.0,61.0
11.4375,16,7,9,44.0,56.0
31.941176470588236,17,9,8,53.0,47.0
23.0,8,3,5,38.0,62.0
7.0,3,3,0,100.0,0.0
10.666666666666666,3,1,2,33.0,67.0
18.4,5,4,1,80.0,20.0
12.72,25,15,10,60.0,40.0
12.158536585365853,82,52,30,63.0,37.0
13.984126984126984,126,73,53,58.0,42.0
14.092307692307692,65,33,32,51.0,49.0
21.203389830508474,59,23,36,39.0,61.0
26.863636363636363,88,28,60,32.0,68.0
28.576923076923077,130,41,89,32.0,68.0
24.990291262135923,103,28,75,27.0,73.0
23.532608695652176,92,37,55,40.0,60.0
24.879310344827587,116,43,73,37.0,63.0
20.174496644295303,149,69,80,46.0,54.0
37.27947598253275,229,89,140,39.0,61.0
25.858024691358025,162,64,98,40.0,60.0
20.555555555555557,135,49,86,36.0,64.0
23.045454545454547,88,21,67,24.0,76.0
17.770491803278688,61,24,37,39.0,61.0
20.303030303030305,33,20,13,61.0,39.0
15.272727272727273,33,11,22,33.0,67.0
21.375,16,8,8,50.0,50.0
18.333333333333332,6,1,5,17.0,83.0
13.25,8,5,3,62.0,38.0
72.0,2,2,0,100.0,0.0
21.666666666666668,3,2,1,67.0,33.0
30.5,10,7,3,70.0,30.0
81.46428571428571,28,12,16,43.0,57.0
13.407407407407407,81,45,36,56.0,44.0
13.75925925925926,108,58,50,54.0,46.0
20.01388888888889,72,35,37,49.0,51.0
25.011904761904763,84,25,59,30.0,70.0
36.08270676691729,133,26,107,20.0,80.0
19.202312138728324,173,54,119,31.0,69.0
29.091603053435115,131,35,96,27.0,73.0
32.41916167664671,167,42,125,25.0,75.0
33.95384615384615,130,30,100,23.0,77.0
21.467336683417084,199,54,145,27.0,73.0
22.964912280701753,228,61,167,27.0,73.0
30.896551724137932,174,46,128,26.0,74.0
22.283870967741937,155,33,122,21.0,79.0
26.571428571428573,112,26,86,23.0,77.0
33.43333333333333,90,23,67,26.0,74.0
22.701149425287355,87,18,69,21.0,79.0
32.25,56,5,51,9.0,91.0
26.636363636363637,22,6,16,27.0,73.0
23.454545454545453,33,5,28,15.0,85.0
35.666666666666664,6,3,3,50.0,50.0
6.0,2,2,0,100.0,0.0
2.6666666666666665,3,3,0,100.0,0.0
1.2,5,5,0,100.0,0.0
9.272727272727273,11,8,3,73.0,27.0
137.92857142857142,14,6,8,43.0,57.0
20.72340425531915,47,24,23,51.0,49.0
19.541666666666668,72,21,51,29.0,71.0
21.93167701863354,161,18,143,11.0,89.0
27.327014218009477,211,51,160,24.0,76.0
32.0,262,58,204,22.0,78.0
36.19178082191781,219,37,182,17.0,83.0
37.549019607843135,255,47,208,18.0,82.0
26.783673469387754,245,34,211,14.0,86.0
21.240174672489083,229,41,188,18.0,82.0
30.44,100,15,85,15.0,85.0
29.279411764705884,136,21,115,15.0,85.0
24.91111111111111,90,13,77,14.0,86.0
20.61842105263158,76,10,66,13.0,87.0
39.375,64,12,52,19.0,81.0
32.80357142857143,56,10,46,18.0,82.0
28.227272727272727,44,6,38,14.0,86.0
92.5,20,3,17,15.0,85.0
15.466666666666667,15,4,11,27.0,73.0
24.625,8,2,6,25.0,75.0
6.0,1,1,0,100.0,0.0
29.333333333333332,3,2,1,67.0,33.0
4.0,5,5,0,100.0,0.0
15.7,10,6,4,60.0,40.0
40.5,18,11,7,61.0,39.0
14.791666666666666,24,13,11,54.0,46.0
17.823529411764707,51,25,26,49.0,51.0
31.606382978723403,94,23,71,24.0,76.0
43.518248175182485,137,22,115,16.0,84.0
33.879120879120876,182,21,161,12.0,88.0
32.783068783068785,189,37,152,20.0,80.0
33.13145539906103,213,30,183,14.0,86.0
32.589595375722546,173,29,144,17.0,83.0
31.677884615384617,208,42,166,20.0,80.0
23.57718120805369,149,29,120,19.0,81.0
23.994318181818183,176,33,143,19.0,81.0
37.05343511450382,131,27,104,21.0,79.0
50.021126760563384,142,20,122,14.0,86.0
38.72727272727273,99,21,78,21.0,79.0
34.8125,64,12,52,19.0,81.0
20.032258064516128,31,7,24,23.0,77.0
25.272727272727273,11,0,11,0.0,100.0
7.5,6,0,6,0.0,100.0
8.0,1,0,1,0.0,100.0
19.5,2,2,0,100.0,0.0
13.333333333333334,3,0,3,0.0,100.0
10.333333333333334,6,5,1,83.0,17.0
10.8125,16,11,5,69.0,31.0
12.421686746987952,83,43,40,52.0,48.0
12.359223300970873,103,55,48,53.0,47.0
16.96875,64,28,36,44.0,56.0
23.0,83,31,52,37.0,63.0
22.29059829059829,117,36,81,31.0,69.0
25.18421052631579,114,32,82,28.0,72.0
25.80909090909091,110,26,84,24.0,76.0
20.503937007874015,127,39,88,31.0,69.0
42.54135338345865,133,35,98,26.0,74.0
23.796703296703296,182,53,129,29.0,71.0
21.515151515151516,231,91,140,39.0,61.0
27.92105263157895,228,69,159,30.0,70.0
28.042168674698797,166,47,119,28.0,72.0
23.597122302158272,139,30,109,22.0,78.0
14.581395348837209,86,26,60,30.0,70.0
22.581818181818182,55,20,35,36.0,64.0
21.783783783783782,37,11,26,30.0,70.0
22.11111111111111,18,5,13,28.0,72.0
8.6,10,5,5,50.0,50.0
10.0,10,6,4,60.0,40.0
6.0,2,1,1,50.0,50.0
37.0,3,2,1,67.0,33.0
5.785714285714286,14,13,1,93.0,7.0
12.272727272727273,33,21,12,64.0,36.0
12.317073170731707,82,50,32,61.0,39.0
12.544,125,63,62,50.0,50.0
17.17283950617284,81,32,49,40.0,60.0
22.569620253164558,79,32,47,41.0,59.0
20.32846715328467,137,52,85,38.0,62.0
21.292134831460675,178,49,129,28.0,72.0
20.900709219858157,141,36,105,26.0,74.0
25.5,96,33,63,34.0,66.0
19.77777777777778,117,35,82,30.0,70.0
18.635714285714286,140,59,81,42.0,58.0
15.95625,160,70,90,44.0,56.0
51.80392156862745,153,59,94,39.0,61.0
23.780645161290323,155,44,111,28.0,72.0
18.536082474226806,97,31,66,32.0,68.0
16.452830188679247,53,21,32,40.0,60.0
20.513513513513512,37,14,23,38.0,62.0
15.0,6,1,5,17.0,83.0
2.7142857142857144,7,2,5,29.0,71.0
88.4,5,5,0,100.0,0.0
20.375,8,2,6,25.0,75.0
60.5,2,2,0,100.0,0.0
8.666666666666666,3,0,3,0.0,100.0
8.428571428571429,14,10,4,71.0,29.0
15.066666666666666,15,6,9,40.0,60.0
27.57831325301205,83,46,37,55.0,45.0
12.860869565217392,115,58,57,50.0,50.0
15.283950617283951,81,34,47,42.0,58.0
35.10606060606061,66,25,41,38.0,62.0
26.132653061224488,98,35,63,36.0,64.0
15.380281690140846,142,49,93,35.0,65.0
25.177570093457945,107,40,67,37.0,63.0
23.936842105263157,95,35,60,37.0,63.0
21.702970297029704,101,34,67,34.0,66.0
25.50531914893617,188,63,125,34.0,66.0
18.54913294797688,173,75,98,43.0,57.0
19.10857142857143,175,58,117,33.0,67.0
23.608,125,33,92,26.0,74.0
21.02020202020202,99,32,67,32.0,68.0
27.70689655172414,58,20,38,34.0,66.0
21.833333333333332,48,19,29,40.0,60.0
20.70967741935484,31,6,25,19.0,81.0
27.05263157894737,19,2,17,11.0,89.0
36.75,12,7,5,58.0,42.0
9.625,8,4,4,50.0,50.0
8.25,4,0,4,0.0,100.0
7.333333333333333,3,1,2,33.0,67.0
11.933333333333334,15,11,4,73.0,27.0
13.571428571428571,21,12,9,57.0,43.0
12.814814814814815,54,35,19,65.0,35.0
11.901098901098901,91,51,40,56.0,44.0
10.101694915254237,59,34,25,58.0,42.0
27.984375,64,26,38,41.0,59.0
19.52577319587629,97,40,57,41.0,59.0
17.862068965517242,87,34,53,39.0,61.0
20.803571428571427,112,45,67,40.0,60.0
21.618181818181817,55,24,31,44.0,56.0
20.140625,64,24,40,38.0,62.0
24.0381679389313,131,56,75,43.0,57.0
15.064356435643564,202,78,124,39.0,61.0
17.92517006802721,147,62,85,42.0,58.0
17.682692307692307,104,34,70,33.0,67.0
19.013157894736842,76,25,51,33.0,67.0
16.765625,64,15,49,23.0,77.0
18.321428571428573,28,12,16,43.0,57.0
51.48148148148148,27,4,23,15.0,85.0
28.3125,16,4,12,25.0,75.0
10.666666666666666,6,4,2,67.0,33.0
16.6,5,0,5,0.0,100.0
5.285714285714286,7,1,6,14.0,86.0
10.0,2,1,1,50.0,50.0
9.428571428571429,7,5,2,71.0,29.0
12.428571428571429,28,13,15,46.0,54.0
9.861538461538462,65,33,32,51.0,49.0
16.035398230088497,113,58,55,51.0,49.0
13.9,90,39,51,43.0,57.0
22.652173913043477,69,23,46,33.0,67.0
21.306451612903224,124,32,92,26.0,74.0
23.242424242424242,165,44,121,27.0,73.0
17.98709677419355,155,44,111,28.0,72.0
24.06756756756757,148,39,109,26.0,74.0
26.46783625730994,171,58,113,34.0,66.0
21.344978165938866,229,70,159,31.0,69.0
24.042918454935624,233,67,166,29.0,71.0
27.246511627906976,215,53,162,25.0,75.0
24.602564102564102,156,36,120,23.0,77.0
26.181818181818183,110,27,83,25.0,75.0
17.20618556701031,97,28,69,29.0,71.0
23.75,64,12,52,19.0,81.0
24.76595744680851,47,10,37,21.0,79.0
28.166666666666668,36,12,24,33.0,67.0
16.307692307692307,13,5,8,38.0,62.0
27.0,18,3,15,17.0,83.0
9.0,10,2,8,20.0,80.0
28.833333333333332,6,2,4,33.0,67.0
18.142857142857142,7,5,2,71.0,29.0
11.75,8,3,5,38.0,62.0
54.16,25,10,15,40.0,60.0
29.195121951219512,41,14,27,34.0,66.0
47.506493506493506,77,16,61,21.0,79.0
28.3015873015873,126,20,106,16.0,84.0
32.54216867469879,166,38,128,23.0,77.0
41.35146443514645,239,42,197,18.0,82.0
33.4014598540146,274,41,233,15.0,85.0
40.38509316770186,322,51,271,16.0,84.0
33.8021978021978,364,45,319,12.0,88.0
41.53134328358209,335,51,284,15.0,85.0
33.5859872611465,314,42,272,13.0,87.0
27.157258064516128,248,54,194,22.0,78.0
38.637010676156585,281,33,248,12.0,88.0
31.263157894736842,247,31,216,13.0,87.0
39.17142857142857,175,31,144,18.0,82.0
31.986301369863014,146,24,122,16.0,84.0
26.0,68,17,51,25.0,75.0
27.33823529411765,68,8,60,12.0,88.0
31.694444444444443,36,5,31,14.0,86.0
33.11538461538461,26,6,20,23.0,77.0
10.0,5,2,3,40.0,60.0
7.142857142857143,7,2,5,29.0,71.0
13.0,5,1,4,20.0,80.0
27.3125,16,7,9,44.0,56.0
36.88235294117647,17,7,10,41.0,59.0
32.05882352941177,51,20,31,39.0,61.0
25.57281553398058,103,18,85,17.0,83.0
32.91954022988506,174,39,135,22.0,78.0
38.51417004048583,247,63,184,26.0,74.0
37.62926829268293,205,39,166,19.0,81.0
38.14070351758794,199,32,167,16.0,84.0
33.97285067873303,221,34,187,15.0,85.0
30.17735849056604,265,57,208,22.0,78.0
29.24537037037037,216,44,172,20.0,80.0
28.617021276595743,188,24,164,13.0,87.0
25.717821782178216,202,34,168,17.0,83.0
30.612903225806452,186,23,163,12.0,88.0
25.283464566929133,127,21,106,17.0,83.0
35.483870967741936,155,20,135,13.0,87.0
29.70769230769231,65,14,51,22.0,78.0
48.833333333333336,30,4,26,13.0,87.0
36.35294117647059,17,5,12,29.0,71.0
17.75,4,3,1,75.0,25.0
46.785714285714285,14,5,9,36.0,64.0
29.0,4,3,1,75.0,25.0
89.0,2,2,0,100.0,0.0
6.0,7,6,1,86.0,14.0
12.166666666666666,24,11,13,46.0,54.0
24.069444444444443,72,37,35,51.0,49.0
14.427184466019417,103,56,47,54.0,46.0
14.35,80,36,44,45.0,55.0
28.796296296296298,108,48,60,44.0,56.0
21.364341085271317,129,42,87,33.0,67.0
26.688622754491018,167,42,125,25.0,75.0
25.795620437956206,137,49,88,36.0,64.0
23.0859375,128,37,91,29.0,71.0
21.041666666666668,144,28,116,19.0,81.0
20.035502958579883,169,50,119,30.0,70.0
21.20883534136546,249,87,162,35.0,65.0
25.693069306930692,202,44,158,22.0,78.0
27.89171974522293,157,39,118,25.0,75.0
27.92168674698795,166,38,128,23.0,77.0
28.894736842105264,133,21,112,16.0,84.0
34.93975903614458,83,15,68,18.0,82.0
13.222222222222221,18,3,15,17.0,83.0
118.70588235294117,17,6,11,35.0,65.0
24.363636363636363,22,5,17,23.0,77.0
31.333333333333332,3,2,1,67.0,33.0
7.5,4,2,2,50.0,50.0
27.5,4,0,4,0.0,100.0
5.416666666666667,12,9,3,75.0,25.0
13.382352941176471,34,14,20,41.0,59.0
12.595505617977528,89,46,43,52.0,48.0
10.632075471698114,106,59,47,56.0,44.0
13.037974683544304,79,33,46,42.0,58.0
17.876404494382022,89,27,62,30.0,70.0
24.91588785046729,107,43,64,40.0,60.0
19.669421487603305,121,43,78,36.0,64.0
18.816326530612244,98,37,61,38.0,62.0
20.294642857142858,112,37,75,33.0,67.0
25.397163120567377,141,40,101,28.0,72.0
24.548223350253807,197,55,142,28.0,72.0
20.7725321888412,233,79,154,34.0,66.0
30.038793103448278,232,66,166,28.0,72.0
31.664383561643834,146,42,104,29.0,71.0
23.100719424460433,139,33,106,24.0,76.0
28.28,100,32,68,32.0,68.0
21.446428571428573,56,18,38,32.0,68.0
21.4,20,5,15,25.0,75.0
27.285714285714285,28,8,20,29.0,71.0
30.166666666666668,6,4,2,67.0,33.0
36.2,5,1,4,20.0,80.0
29.5,2,1,1,50.0,50.0
10.6,5,4,1,80.0,20.0
13.545454545454545,11,6,5,55.0,45.0
12.162162162162161,37,13,24,35.0,65.0
19.151162790697676,86,48,38,56.0,44.0
10.385416666666666,96,45,51,47.0,53.0
171.7710843373494,83,46,37,55.0,45.0
16.16470588235294,85,34,51,40.0,60.0
23.841269841269842,126,37,89,29.0,71.0
18.1858407079646,113,40,73,35.0,65.0
21.641025641025642,117,43,74,37.0,63.0
18.237623762376238,101,31,70,31.0,69.0
19.68,125,47,78,38.0,62.0
21.4390243902439,164,55,109,34.0,66.0
18.64788732394366,213,76,137,36.0,64.0
17.288888888888888,180,64,116,36.0,64.0
21.876106194690266,113,32,81,28.0,72.0
17.820224719101123,89,21,68,24.0,76.0
18.53125,64,25,39,39.0,61.0
36.19277108433735,83,24,59,29.0,71.0
13.26086956521739,23,7,16,30.0,70.0
23.5,16,6,10,38.0,62.0
25.3,20,6,14,30.0,70.0
24.4,5,2,3,40.0,60.0
10.0,1,1,0,100.0,0.0
27.5,4,3,1,75.0,25.0
15.4,10,5,5,50.0,50.0
11.0,34,17,17,50.0,50.0
30.896551724137932,87,52,35,60.0,40.0
11.423913043478262,92,54,38,59.0,41.0
16.47826086956522,46,25,21,54.0,46.0
16.38961038961039,77,31,46,40.0,60.0
16.785046728971963,107,47,60,44.0,56.0
17.632911392405063,158,53,105,34.0,66.0
19.25595238095238,168,52,116,31.0,69.0
23.87121212121212,132,47,85,36.0,64.0
17.308641975308642,162,47,115,29.0,71.0
27.934343434343436,198,61,137,31.0,69.0
18.88118811881188,202,78,124,39.0,61.0
16.597122302158272,139,50,89,36.0,64.0
23.275449101796408,167,47,120,28.0,72.0
16.9375,112,29,83,26.0,74.0
23.859375,64,18,46,28.0,72.0
22.796610169491526,59,21,38,36.0,64.0
25.833333333333332,30,7,23,23.0,77.0
19.0,24,4,20,17.0,83.0
29.666666666666668,24,2,22,8.0,92.0
58.84615384615385,13,6,7,46.0,54.0
22.2,5,1,4,20.0,80.0
36.8,5,2,3,40.0,60.0
17.583333333333332,24,12,12,50.0,50.0
10.447368421052632,38,17,21,45.0,55.0
11.75294117647059,85,45,40,53.0,47.0
14.672131147540984,122,59,63,48.0,52.0
15.620689655172415,87,40,47,46.0,54.0
26.666666666666668,87,29,58,33.0,67.0
23.08609271523179,151,38,113,25.0,75.0
24.174358974358974,195,44,151,23.0,77.0
26.755102040816325,196,42,154,21.0,79.0
22.847826086956523,138,32,106,23.0,77.0
23.015706806282722,191,41,150,21.0,79.0
19.14691943127962,211,65,146,31.0,69.0
32.14509803921569,255,75,180,29.0,71.0
30.13364055299539,217,48,169,22.0,78.0
28.96039603960396,202,40,162,20.0,80.0
25.035928143712574,167,31,136,19.0,81.0
25.44295302013423,149,26,123,17.0,83.0
21.696629213483146,89,20,69,22.0,78.0
25.256410256410255,78,8,70,10.0,90.0
35.41379310344828,29,2,27,7.0,93.0
37.44444444444444,27,7,20,26.0,74.0
51.39393939393939,33,10,23,30.0,70.0
4.0,1,1,0,100.0,0.0
16.5,2,0,2,0.0,100.0
9.571428571428571,7,4,3,57.0,43.0
18.083333333333332,12,4,8,33.0,67.0
13.428571428571429,21,6,15,29.0,71.0
26.6875,64,16,48,25.0,75.0
24.60683760683761,117,39,78,33.0,67.0
23.176,125,31,94,25.0,75.0
24.901639344262296,244,41,203,17.0,83.0
25.804878048780488,205,29,176,14.0,86.0
30.40753424657534,292,23,269,8.0,92.0
30.178947368421053,380,49,331,13.0,87.0
31.67621776504298,349,35,314,10.0,90.0
27.727544910179642,334,30,304,9.0,91.0
31.881789137380192,313,43,270,14.0,86.0
29.0,245,27,218,11.0,89.0
23.37109375,256,19,237,7.0,93.0
29.623255813953488,215,18,197,8.0,92.0
32.45454545454545,143,20,123,14.0,86.0
30.77181208053691,149,16,133,11.0,89.0
58.96521739130435,115,8,107,7.0,93.0
34.22222222222222,72,19,53,26.0,74.0
43.93617021276596,47,5,42,11.0,89.0
18.235294117647058,34,5,29,15.0,85.0
18.0,3,0,3,0.0,100.0
9.0,2,1,1,50.0,50.0
7.333333333333333,3,0,3,0.0,100.0
5.8,5,2,3,40.0,60.0
16.869565217391305,23,9,14,39.0,61.0
29.68888888888889,45,12,33,27.0,73.0
24.142857142857142,91,27,64,30.0,70.0
29.3,130,21,109,16.0,84.0
40.795,200,27,173,14.0,86.0
47.33948339483395,271,26,245,10.0,90.0
35.62017804154303,337,36,301,11.0,89.0
35.73837209302326,344,40,304,12.0,88.0
35.07309941520468,342,31,311,9.0,91.0
30.545774647887324,284,46,238,16.0,84.0
27.624505928853754,253,34,219,13.0,87.0
28.057471264367816,261,33,228,13.0,87.0
27.663414634146342,205,17,188,8.0,92.0
29.56578947368421,228,33,195,14.0,86.0
39.5,186,20,166,11.0,89.0
34.89473684210526,76,6,70,8.0,92.0
19.11864406779661,59,15,44,25.0,75.0
23.31578947368421,19,3,16,16.0,84.0
20.1,10,0,10,0.0,100.0
70.22727272727273,22,1,21,5.0,95.0
15.0,1,0,1,0.0,100.0
8.2,5,3,2,60.0,40.0
7.75,8,6,2,75.0,25.0
9.655172413793103,29,19,10,66.0,34.0
12.573033707865168,89,39,50,44.0,56.0
10.867924528301886,106,60,46,57.0,43.0
12.795698924731182,93,42,51,45.0,55.0
18.908256880733944,109,34,75,31.0,69.0
21.923076923076923,143,33,110,23.0,77.0
20.50857142857143,175,45,130,26.0,74.0
26.078125,192,64,128,33.0,67.0
28.169398907103826,183,46,137,25.0,75.0
28.914893617021278,188,40,148,21.0,79.0
24.099601593625497,251,68,183,27.0,73.0
21.73828125,256,85,171,33.0,67.0
32.41836734693877,196,48,148,24.0,76.0
29.497512437810947,201,35,166,17.0,83.0
25.965317919075144,173,32,141,18.0,82.0
21.646464646464647,99,13,86,13.0,87.0
18.705882352941178,85,27,58,32.0,68.0
33.58,50,9,41,18.0,82.0
25.0,26,6,20,23.0,77.0
31.272727272727273,11,3,8,27.0,73.0
5.5,2,0,2,0.0,100.0
21.0,1,0,1,0.0,100.0
23.0,7,3,4,43.0,57.0
7.111111111111111,9,5,4,56.0,44.0
17.205128205128204,39,14,25,36.0,64.0
12.475,80,41,39,51.0,49.0
12.640287769784173,139,73,66,53.0,47.0
11.24742268041237,97,38,59,39.0,61.0
19.142857142857142,98,35,63,36.0,64.0
20.318471337579616,157,45,112,29.0,71.0
20.939086294416242,197,44,153,22.0,78.0
30.085365853658537,164,44,120,27.0,73.0
24.85211267605634,142,41,101,29.0,71.0
23.592307692307692,130,40,90,31.0,69.0
25.711340206185568,194,55,139,28.0,72.0
27.439834024896264,241,73,168,30.0,70.0
26.1866028708134,209,52,157,25.0,75.0
31.41747572815534,206,50,156,24.0,76.0
28.307692307692307,182,27,155,15.0,85.0
33.84166666666667,120,27,93,22.0,78.0
35.08196721311475,61,9,52,15.0,85.0
23.416666666666668,72,9,63,12.0,88.0
24.8,30,8,22,27.0,73.0
21.15,20,0,20,0.0,100.0
60.416666666666664,12,0,12,0.0,100.0
40.5,4,1,3,25.0,75.0
12.0,5,1,4,20.0,80.0
13.0,16,13,3,81.0,19.0
11.609756097560975,41,18,23,44.0,56.0
14.03896103896104,77,41,36,53.0,47.0
14.069620253164556,158,78,80,49.0,51.0
15.285714285714286,63,30,33,48.0,52.0
28.193181818181817,88,40,48,45.0,55.0
20.26890756302521,119,40,79,34.0,66.0
21.92929292929293,198,65,133,33.0,67.0
19.5,164,45,119,27.0,73.0
28.29192546583851,161,43,118,27.0,73.0
28.36986301369863,146,42,104,29.0,71.0
18.92972972972973,185,59,126,32.0,68.0
21.659574468085108,235,80,155,34.0,66.0
26.875598086124402,209,58,151,28.0,72.0
31.181372549019606,204,44,160,22.0,78.0
27.626436781609197,174,37,137,21.0,79.0
29.470588235294116,102,25,77,25.0,75.0
16.945454545454545,55,16,39,29.0,71.0
28.612903225806452,62,11,51,18.0,82.0
27.903225806451612,31,2,29,6.0,94.0
57.827586206896555,29,6,23,21.0,79.0
19.833333333333332,6,0,6,0.0,100.0
16.0,4,1,3,25.0,75.0
34.72727272727273,11,5,6,45.0,55.0
26.90909090909091,11,5,6,45.0,55.0
12.964285714285714,28,14,14,50.0,50.0
13.30232558139535,86,45,41,52.0,48.0
14.975609756097562,123,68,55,55.0,45.0
18.797752808988765,89,30,59,34.0,66.0
19.811764705882354,85,32,53,38.0,62.0
22.641666666666666,120,36,84,30.0,70.0
21.851063829787233,141,35,106,25.0,75.0
19.914728682170544,129,36,93,28.0,72.0
22.69924812030075,133,29,104,22.0,78.0
23.20108695652174,184,42,142,23.0,77.0
20.70046082949309,217,66,151,30.0,70.0
20.074688796680498,241,77,164,32.0,68.0
21.009345794392523,214,70,144,33.0,67.0
28.756880733944953,218,59,159,27.0,73.0
26.61764705882353,170,31,139,18.0,82.0
21.7007299270073,137,28,109,20.0,80.0
26.36190476190476,105,27,78,26.0,74.0
24.365079365079364,63,15,48,24.0,76.0
26.697674418604652,43,6,37,14.0,86.0
35.869565217391305,23,3,20,13.0,87.0
392.6666666666667,12,4,8,33.0,67.0
10.0,5,2,3,40.0,60.0
12.0,2,1,1,50.0,50.0
46.94444444444444,18,10,8,56.0,44.0
12.826086956521738,23,9,14,39.0,61.0
15.75609756097561,82,48,34,59.0,41.0
14.72992700729927,137,56,81,41.0,59.0
23.764044943820224,89,35,54,39.0,61.0
17.639344262295083,122,20,102,16.0,84.0
26.43548387096774,186,37,149,20.0,80.0
28.190184049079754,163,47,116,29.0,71.0
28.990654205607477,214,49,165,23.0,77.0
26.86387434554974,191,35,156,18.0,82.0
28.62934362934363,259,47,212,18.0,82.0
22.06081081081081,296,60,236,20.0,80.0
21.455696202531644,237,63,174,27.0,73.0
23.632,250,54,196,22.0,78.0
23.28358208955224,201,35,166,17.0,83.0
23.295774647887324,213,33,180,15.0,85.0
30.51396648044693,179,29,150,16.0,84.0
25.740458015267176,131,19,112,15.0,85.0
30.364406779661017,118,18,100,15.0,85.0
37.042857142857144,70,10,60,14.0,86.0
38.03225806451613,31,6,25,19.0,81.0
34.407407407407405,27,5,22,19.0,81.0
10.0,5,0,5,0.0,100.0
21.5,4,0,4,0.0,100.0
13.0,3,2,1,67.0,33.0
14.058823529411764,17,7,10,41.0,59.0
10.647058823529411,17,7,10,41.0,59.0
34.53191489361702,47,23,24,49.0,51.0
19.5,64,16,48,25.0,75.0
24.553846153846155,130,25,105,19.0,81.0
27.375,200,34,166,17.0,83.0
25.606060606060606,231,31,200,13.0,87.0
33.73202614379085,306,28,278,9.0,91.0
30.60919540229885,348,29,319,8.0,92.0
31.833333333333332,342,26,316,8.0,92.0
30.87730061349693,326,25,301,8.0,92.0
28.01060070671378,283,30,253,11.0,89.0
28.43217665615142,317,38,279,12.0,88.0
35.1712962962963,216,17,199,8.0,92.0
26.353191489361702,235,28,207,12.0,88.0
33.540084388185655,237,35,202,15.0,85.0
34.8421052631579,133,16,117,12.0,88.0
31.385964912280702,114,17,97,15.0,85.0
38.46268656716418,67,4,63,6.0,94.0
38.203125,64,15,49,23.0,77.0
22.82608695652174,23,2,21,9.0,91.0
554.0,9,1,8,11.0,89.0
11.5,4,1,3,25.0,75.0
19.4,5,1,4,20.0,80.0
10.333333333333334,12,4,8,33.0,67.0
14.705882352941176,17,7,10,41.0,59.0
28.301204819277107,83,20,63,24.0,76.0
27.791666666666668,96,14,82,15.0,85.0
36.56216216216216,185,21,164,11.0,89.0
30.91941391941392,273,32,241,12.0,88.0
36.414330218068535,321,36,285,11.0,89.0
36.48774509803921,408,37,371,9.0,91.0
34.41079812206573,426,36,390,8.0,92.0
33.61964735516373,397,42,355,11.0,89.0
31.744588744588743,462,43,419,9.0,91.0
33.039164490861616,383,42,341,11.0,89.0
36.51744186046512,344,31,313,9.0,91.0
45.325806451612905,310,31,279,10.0,90.0
29.746031746031747,315,27,288,9.0,91.0
31.76605504587156,218,16,202,7.0,93.0
34.23111111111111,225,17,208,8.0,92.0
30.548387096774192,93,11,82,12.0,88.0
84.74545454545455,55,7,48,13.0,87.0
37.94117647058823,34,4,30,12.0,88.0
24.074074074074073,27,3,24,11.0,89.0
29.166666666666668,6,2,4,33.0,67.0
8.666666666666666,3,2,1,67.0,33.0
4.75,8,3,5,38.0,62.0
12.307692307692308,13,4,9,31.0,69.0
28.833333333333332,30,11,19,37.0,63.0
23.645833333333332,48,7,41,15.0,85.0
36.27,100,22,78,22.0,78.0
36.285714285714285,175,18,157,10.0,90.0
33.32,200,25,175,12.0,88.0
39.33098591549296,284,38,246,13.0,87.0
38.468152866242036,314,32,282,10.0,90.0
35.55733333333333,375,38,337,10.0,90.0
34.45974025974026,385,42,343,11.0,89.0
34.70505617977528,356,39,317,11.0,89.0
27.82450331125828,302,28,274,9.0,91.0
33.28104575163399,306,34,272,11.0,89.0
31.25311203319502,241,33,208,14.0,86.0
24.476190476190474,210,38,172,18.0,82.0
26.91743119266055,109,10,99,9.0,91.0
27.05128205128205,78,11,67,14.0,86.0
109.80645161290323,31,6,25,19.0,81.0
49.526315789473685,19,3,16,16.0,84.0
39.333333333333336,3,1,2,33.0,67.0
30.714285714285715,7,2,5,29.0,71.0
148.33333333333334,3,0,3,0.0,100.0
16.0,2,1,1,50.0,50.0
18.0,12,8,4,67.0,33.0
13.076923076923077,26,14,12,54.0,46.0
9.666666666666666,66,40,26,61.0,39.0
12.816,125,59,66,47.0,53.0
17.546666666666667,75,31,44,41.0,59.0
24.337078651685392,89,29,60,33.0,67.0
15.627272727272727,110,40,70,36.0,64.0
18.683823529411764,136,34,102,25.0,75.0
22.38125,160,43,117,27.0,73.0
23.742424242424242,132,36,96,27.0,73.0
23.25563909774436,133,40,93,30.0,70.0
25.448453608247423,194,58,136,30.0,70.0
20.98739495798319,238,95,143,40.0,60.0
18.982456140350877,171,51,120,30.0,70.0
30.469945355191257,183,26,157,14.0,86.0
30.442028985507246,138,24,114,17.0,83.0
23.13,100,19,81,19.0,81.0
18.134328358208954,67,16,51,24.0,76.0
14.045454545454545,22,3,19,14.0,86.0
35.21052631578947,19,5,14,26.0,74.0
34.63157894736842,19,1,18,5.0,95.0
37.27272727272727,11,2,9,18.0,82.0
34.5,6,2,4,33.0,67.0
17.5,2,1,1,50.0,50.0
18.11111111111111,9,5,4,56.0,44.0
11.371428571428572,35,22,13,63.0,37.0
11.444444444444445,81,45,36,56.0,44.0
10.456896551724139,116,59,57,51.0,49.0
10.873015873015873,63,25,38,40.0,60.0
16.73972602739726,73,31,42,42.0,58.0
31.0,101,27,74,27.0,73.0
19.29559748427673,159,55,104,35.0,65.0
28.176056338028168,142,37,105,26.0,74.0
25.48170731707317,164,34,130,21.0,79.0
17.74436090225564,133,53,80,40.0,60.0
20.377906976744185,172,52,120,30.0,70.0
19.677551020408163,245,90,155,37.0,63.0
29.713043478260868,230,62,168,27.0,73.0
22.77005347593583,187,55,132,29.0,71.0
27.55862068965517,145,31,114,21.0,79.0
22.191358024691358,162,22,140,14.0,86.0
24.67543859649123,114,18,96,16.0,84.0
14.290909090909091,55,8,47,15.0,85.0
24.96,25,7,18,28.0,72.0
16.8,25,1,24,4.0,96.0
19.25,4,0,4,0.0,100.0
139.5,4,3,1,75.0,25.0
28.0,4,1,3,25.0,75.0
8.0,12,9,3,75.0,25.0
7.9655172413793105,29,14,15,48.0,52.0
8.869565217391305,69,39,30,57.0,43.0
12.047244094488189,127,60,67,47.0,53.0
18.71014492753623,69,27,42,39.0,61.0
27.987654320987655,81,28,53,35.0,65.0
19.847457627118644,118,40,78,34.0,66.0
24.86,150,46,104,31.0,69.0
18.44776119402985,134,46,88,34.0,66.0
20.210526315789473,133,44,89,33.0,67.0
26.2027027027027,148,46,102,31.0,69.0
18.953216374269005,171,64,107,37.0,63.0
19.76388888888889,216,73,143,34.0,66.0
22.90909090909091,187,57,130,30.0,70.0
21.044871794871796,156,35,121,22.0,78.0
18.253333333333334,75,27,48,36.0,64.0
21.857142857142858,42,13,29,31.0,69.0
21.6875,48,14,34,29.0,71.0
18.3125,32,3,29,9.0,91.0
40.6,10,4,6,40.0,60.0
14.4,10,4,6,40.0,60.0
16.285714285714285,7,1,6,14.0,86.0
44.6,5,2,3,40.0,60.0
9.0,1,1,0,100.0,0.0
28.58823529411765,17,11,6,65.0,35.0
10.31578947368421,19,11,8,58.0,42.0
14.672131147540984,61,37,24,61.0,39.0
11.835164835164836,91,52,39,57.0,43.0
33.98,50,25,25,50.0,50.0
18.49019607843137,51,19,32,37.0,63.0
27.08823529411765,68,22,46,32.0,68.0
17.885416666666668,96,30,66,31.0,69.0
22.213483146067414,89,31,58,35.0,65.0
35.75,112,35,77,31.0,69.0
22.271844660194176,103,44,59,43.0,57.0
21.007142857142856,140,57,83,41.0,59.0
20.095808383233532,167,83,84,50.0,50.0
27.616,125,48,77,38.0,62.0
19.701030927835053,97,34,63,35.0,65.0
23.427350427350426,117,35,82,30.0,70.0
19.8659793814433,97,23,74,24.0,76.0
10.604166666666666,48,19,29,40.0,60.0
33.57142857142857,63,13,50,21.0,79.0
22.72,25,4,21,16.0,84.0
200.94444444444446,18,7,11,39.0,61.0
23.0,10,4,6,40.0,60.0
8.333333333333334,3,1,2,33.0,67.0
15.666666666666666,3,2,1,67.0,33.0
17.0,1,1,0,100.0,0.0
19.384615384615383,13,7,6,54.0,46.0
31.23076923076923,13,8,5,62.0,38.0
18.404761904761905,42,20,22,48.0,52.0
27.63768115942029,69,25,44,36.0,64.0
30.30841121495327,107,27,80,25.0,75.0
41.30718954248366,153,37,116,24.0,76.0
29.607142857142858,168,36,132,21.0,79.0
29.13364055299539,217,51,166,24.0,76.0
28.970760233918128,171,36,135,21.0,79.0
32.82887700534759,187,38,149,20.0,80.0
27.4792899408284,169,37,132,22.0,78.0
36.7906976744186,172,45,127,26.0,74.0
27.537634408602152,186,41,145,22.0,78.0
46.46666666666667,135,30,105,22.0,78.0
33.35947712418301,153,43,110,28.0,72.0
22.95967741935484,124,27,97,22.0,78.0
44.58163265306123,98,19,79,19.0,81.0
34.6530612244898,49,16,33,33.0,67.0
23.636363636363637,33,8,25,24.0,76.0
23.433333333333334,30,3,27,10.0,90.0
15.904761904761905,21,6,15,29.0,71.0
10.2,10,5,5,50.0,50.0
10.777777777777779,9,6,3,67.0,33.0
34.5,4,3,1,75.0,25.0
8.0,13,6,7,46.0,54.0
20.15,20,10,10,50.0,50.0
23.885714285714286,35,14,21,40.0,60.0
23.75,60,24,36,40.0,60.0
24.55263157894737,76,25,51,33.0,67.0
30.90909090909091,110,29,81,26.0,74.0
30.51818181818182,110,30,80,27.0,73.0
29.127118644067796,118,21,97,18.0,82.0
49.083333333333336,132,31,101,23.0,77.0
39.318518518518516,135,40,95,30.0,70.0
24.264705882352942,102,19,83,19.0,81.0
29.473684210526315,38,13,25,34.0,66.0
24.373737373737374,99,36,63,36.0,64.0
19.945652173913043,92,25,67,27.0,73.0
23.283333333333335,60,14,46,23.0,77.0
18.916666666666668,48,13,35,27.0,73.0
18.41860465116279,43,15,28,35.0,65.0
23.571428571428573,21,4,17,19.0,81.0
22.3125,16,3,13,19.0,81.0
23.75,8,2,6,25.0,75.0
14.666666666666666,3,2,1,67.0,33.0
6.0,3,3,0,100.0,0.0
31.5,2,1,1,50.0,50.0
5.444444444444445,9,8,1,89.0,11.0
9.384615384615385,26,16,10,62.0,38.0
10.786666666666667,75,50,25,67.0,33.0
12.541176470588235,85,52,33,61.0,39.0
20.05,60,36,24,60.0,40.0
17.8,55,21,34,38.0,62.0
15.036144578313253,83,36,47,43.0,57.0
31.2987012987013,77,30,47,39.0,61.0
23.25609756097561,82,32,50,39.0,61.0
24.357142857142858,70,27,43,39.0,61.0
22.604938271604937,81,39,42,48.0,52.0
22.333333333333332,135,52,83,39.0,61.0
18.39673913043478,184,68,116,37.0,63.0
14.530973451327434,113,46,67,41.0,59.0
21.24137931034483,87,28,59,32.0,68.0
22.265625,64,25,39,39.0,61.0
15.475409836065573,61,20,41,33.0,67.0
11.571428571428571,21,8,13,38.0,62.0
13.444444444444445,9,1,8,11.0,89.0
32.27272727272727,11,8,3,73.0,27.0
9.571428571428571,7,3,4,43.0,57.0
3.2,5,2,3,40.0,60.0
10.0,4,1,3,25.0,75.0
29.0,3,0,3,0.0,100.0
10.5,10,5,5,50.0,50.0
6.916666666666667,24,14,10,58.0,42.0
10.681818181818182,66,41,25,62.0,38.0
12.79,100,64,36,64.0,36.0
18.133333333333333,60,35,25,58.0,42.0
15.829787234042554,47,29,18,62.0,38.0
21.691358024691358,81,30,51,37.0,63.0
20.88888888888889,108,43,65,40.0,60.0
21.806818181818183,88,46,42,52.0,48.0
22.146341463414632,82,29,53,35.0,65.0
25.10377358490566,106,48,58,45.0,55.0
30.118110236220474,127,53,74,42.0,58.0
18.404761904761905,168,85,83,51.0,49.0
17.390243902439025,123,52,71,42.0,58.0
24.77358490566038,106,43,63,41.0,59.0
17.821428571428573,84,23,61,27.0,73.0
20.681818181818183,66,22,44,33.0,67.0
23.02857142857143,35,12,23,34.0,66.0
10.6875,16,4,12,25.0,75.0
45.75,8,4,4,50.0,50.0
25.5,2,0,2,0.0,100.0
57.666666666666664,3,0,3,0.0,100.0
4.333333333333333,3,2,1,67.0,33.0
37.5,2,0,2,0.0,100.0
24.636363636363637,11,1,10,9.0,91.0
12.0,26,14,12,54.0,46.0
11.077922077922079,77,38,39,49.0,51.0
13.079545454545455,88,50,38,57.0,43.0
9.909090909090908,55,29,26,53.0,47.0
23.112676056338028,71,26,45,37.0,63.0
16.135135135135137,74,22,52,30.0,70.0
20.097087378640776,103,40,63,39.0,61.0
20.5,86,34,52,40.0,60.0
26.42391304347826,92,28,64,30.0,70.0
25.511627906976745,86,32,54,37.0,63.0
16.87323943661972,142,60,82,42.0,58.0
15.945,200,79,121,40.0,60.0
18.543624161073826,149,76,73,51.0,49.0
18.641025641025642,117,44,73,38.0,62.0
21.25609756097561,82,37,45,45.0,55.0
13.723684210526315,76,27,49,36.0,64.0
8.102564102564102,39,20,19,51.0,49.0
18.692307692307693,26,11,15,42.0,58.0
19.727272727272727,22,8,14,36.0,64.0
10.88888888888889,9,6,3,67.0,33.0
19.625,8,3,5,38.0,62.0
62.0,1,1,0,100.0,0.0
5.0,2,1,1,50.0,50.0
16.0,10,4,6,40.0,60.0
13.952380952380953,21,16,5,76.0,24.0
16.794117647058822,68,28,40,41.0,59.0
12.325842696629213,89,53,36,60.0,40.0
19.098360655737704,61,22,39,36.0,64.0
15.854166666666666,48,25,23,52.0,48.0
20.388059701492537,67,32,35,48.0,52.0
22.045045045045047,111,41,70,37.0,63.0
18.055555555555557,90,41,49,46.0,54.0
32.36538461538461,104,38,66,37.0,63.0
22.553398058252426,103,34,69,33.0,67.0
21.54901960784314,153,52,101,34.0,66.0
17.415384615384614,195,78,117,40.0,60.0
25.430379746835442,158,50,108,32.0,68.0
24.276119402985074,134,51,83,38.0,62.0
30.66216216216216,74,21,53,28.0,72.0
18.074626865671643,67,23,44,34.0,66.0
26.28,25,6,19,24.0,76.0
26.675,40,14,26,35.0,65.0
11.35,20,4,16,20.0,80.0
32.72727272727273,11,0,11,0.0,100.0
31.0,3,1,2,33.0,67.0
46.0,2,1,1,50.0,50.0
31.0,12,5,7,42.0,58.0
14.0,17,9,8,53.0,47.0
15.096153846153847,52,25,27,48.0,52.0
13.70754716981132,106,54,52,51.0,49.0
24.382978723404257,94,35,59,37.0,63.0
21.416666666666668,96,35,61,36.0,64.0
21.362068965517242,116,31,85,27.0,73.0
18.082474226804123,97,37,60,38.0,62.0
19.546296296296298,108,46,62,43.0,57.0
33.516949152542374,118,38,80,32.0,68.0
12.48314606741573,89,45,44,51.0,49.0
12.714285714285714,42,16,26,38.0,62.0
24.661290322580644,62,26,36,42.0,58.0
14.75,52,23,29,44.0,56.0
12.34375,32,12,20,38.0,62.0
15.307692307692308,26,8,18,31.0,69.0
39.535714285714285,28,12,16,43.0,57.0
15.545454545454545,22,9,13,41.0,59.0
12.692307692307692,13,4,9,31.0,69.0
8.625,8,5,3,62.0,38.0
22.352941176470587,17,9,8,53.0,47.0
8.416666666666666,12,5,7,42.0,58.0
71.57142857142857,7,6,1,86.0,14.0
14.5,4,2,2,50.0,50.0
10.75,4,3,1,75.0,25.0
10.625,8,5,3,62.0,38.0
26.23076923076923,13,5,8,38.0,62.0
18.05263157894737,38,14,24,37.0,63.0
18.733333333333334,75,13,62,17.0,83.0
14.830985915492958,71,17,54,24.0,76.0
23.43243243243243,74,25,49,34.0,66.0
22.340425531914892,94,26,68,28.0,72.0
22.408333333333335,120,36,84,30.0,70.0
24.824675324675326,154,25,129,16.0,84.0
16.684684684684683,111,28,83,25.0,75.0
16.867924528301888,53,19,34,36.0,64.0
19.05,60,16,44,27.0,73.0
17.225,40,12,28,30.0,70.0
16.62962962962963,27,7,20,26.0,74.0
16.64814814814815,54,23,31,43.0,57.0
20.654545454545456,55,13,42,24.0,76.0
73.78947368421052,38,11,27,29.0,71.0
12.037037037037036,27,4,23,15.0,85.0
13.533333333333333,15,4,11,27.0,73.0
12.846153846153847,13,4,9,31.0,69.0
9.0,4,1,3,25.0,75.0
7.0,1,1,0,100.0,0.0
12.0,2,1,1,50.0,50.0
17.0,2,0,2,0.0,100.0
3.0,1,1,0,100.0,0.0
12.571428571428571,7,4,3,57.0,43.0
13.392857142857142,28,14,14,50.0,50.0
22.70967741935484,31,10,21,32.0,68.0
13.051282051282051,39,18,21,46.0,54.0
23.719298245614034,57,18,39,32.0,68.0
16.67391304347826,46,17,29,37.0,63.0
36.94285714285714,35,12,23,34.0,66.0
30.875,48,13,35,27.0,73.0
19.28125,64,28,36,44.0,56.0
13.592592592592593,27,13,14,48.0,52.0
16.21212121212121,33,15,18,45.0,55.0
22.774193548387096,31,11,20,35.0,65.0
9.266666666666667,15,7,8,47.0,53.0
14.777777777777779,9,5,4,56.0,44.0
13.3125,16,12,4,75.0,25.0
12.722222222222221,18,9,9,50.0,50.0
5.142857142857143,14,10,4,71.0,29.0
19.857142857142858,7,1,6,14.0,86.0
16.666666666666668,3,1,2,33.0,67.0
47.666666666666664,3,3,0,100.0,0.0
9.0,1,0,1,0.0,100.0
7.5,4,3,1,75.0,25.0
6.75,4,3,1,75.0,25.0
11.6,10,7,3,70.0,30.0
11.189655172413794,58,29,29,50.0,50.0
10.634146341463415,82,45,37,55.0,45.0
15.653846153846153,52,27,25,52.0,48.0
22.8,65,26,39,40.0,60.0
24.681159420289855,69,27,42,39.0,61.0
23.061728395061728,81,30,51,37.0,63.0
25.79787234042553,94,31,63,33.0,67.0
24.095744680851062,94,34,60,36.0,64.0
19.93877551020408,98,33,65,34.0,66.0
18.598360655737704,122,47,75,39.0,61.0
18.93103448275862,203,73,130,36.0,64.0
19.725352112676056,142,50,92,35.0,65.0
16.313725490196077,102,49,53,48.0,52.0
29.647727272727273,88,17,71,19.0,81.0
14.50943396226415,53,23,30,43.0,57.0
12.7,40,12,28,30.0,70.0
21.870967741935484,31,8,23,26.0,74.0
8.8,20,4,16,20.0,80.0
17.133333333333333,15,3,12,20.0,80.0
10.6,5,2,3,40.0,60.0
4.333333333333333,3,1,2,33.0,67.0
8.0,2,1,1,50.0,50.0
15.4,5,4,1,80.0,20.0
15.791666666666666,24,13,11,54.0,46.0
12.267857142857142,56,28,28,50.0,50.0
10.366071428571429,112,55,57,49.0,51.0
21.714285714285715,56,24,32,43.0,57.0
26.418181818181818,55,30,25,55.0,45.0
18.535714285714285,84,32,52,38.0,62.0
20.393939393939394,99,42,57,42.0,58.0
27.54255319148936,94,31,63,33.0,67.0
21.761363636363637,88,24,64,27.0,73.0
25.27777777777778,90,34,56,38.0,62.0
19.42063492063492,126,49,77,39.0,61.0
17.126666666666665,150,60,90,40.0,60.0
19.790697674418606,129,39,90,30.0,70.0
17.72340425531915,94,37,57,39.0,61.0
23.169642857142858,112,35,77,31.0,69.0
23.63888888888889,72,23,49,32.0,68.0
22.22222222222222,54,20,34,37.0,63.0
11.966666666666667,30,13,17,43.0,57.0
10.923076923076923,13,8,5,62.0,38.0
17.8,10,5,5,50.0,50.0
17.5,2,1,1,50.0,50.0
17.333333333333332,6,2,4,33.0,67.0
9.2,5,2,3,40.0,60.0
12.444444444444445,9,3,6,33.0,67.0
9.416666666666666,24,14,10,58.0,42.0
12.964285714285714,56,27,29,48.0,52.0
10.411111111111111,90,48,42,53.0,47.0
12.596491228070175,57,28,29,49.0,51.0
13.44,50,24,26,48.0,52.0
15.615384615384615,52,24,28,46.0,54.0
17.818181818181817,77,32,45,42.0,58.0
25.315068493150687,73,36,37,49.0,51.0
18.13235294117647,68,22,46,32.0,68.0
18.014285714285716,70,21,49,30.0,70.0
16.95049504950495,101,37,64,37.0,63.0
23.045751633986928,153,62,91,41.0,59.0
16.75,80,29,51,36.0,64.0
18.52747252747253,91,33,58,36.0,64.0
24.014492753623188,69,27,42,39.0,61.0
16.065217391304348,46,21,25,46.0,54.0
16.857142857142858,28,8,20,29.0,71.0
8.857142857142858,14,6,8,43.0,57.0
59.583333333333336,12,4,8,33.0,67.0
8.0,3,2,1,67.0,33.0
16.333333333333332,3,2,1,67.0,33.0
16.555555555555557,9,8,1,89.0,11.0
16.0,12,4,8,33.0,67.0
12.590909090909092,22,14,8,64.0,36.0
11.692307692307692,65,32,33,49.0,51.0
9.29126213592233,103,61,42,59.0,41.0
20.84285714285714,70,30,40,43.0,57.0
19.056338028169016,71,25,46,35.0,65.0
18.278350515463917,97,36,61,37.0,63.0
21.19811320754717,106,38,68,36.0,64.0
16.040816326530614,98,33,65,34.0,66.0
25.152380952380952,105,38,67,36.0,64.0
24.882978723404257,94,37,57,39.0,61.0
17.22222222222222,117,41,76,35.0,65.0
15.062857142857142,175,72,103,41.0,59.0
17.31404958677686,121,40,81,33.0,67.0
23.866666666666667,75,26,49,35.0,65.0
16.16176470588235,68,33,35,49.0,51.0
16.060606060606062,66,33,33,50.0,50.0
22.27777777777778,36,11,25,31.0,69.0
17.956521739130434,23,14,9,61.0,39.0
52.72727272727273,11,6,5,55.0,45.0
24.142857142857142,7,1,6,14.0,86.0
25.142857142857142,7,4,3,57.0,43.0
32.0,1,0,1,0.0,100.0
8.0,2,1,1,50.0,50.0
9.2,15,6,9,40.0,60.0
11.285714285714286,21,5,16,24.0,76.0
13.950819672131148,61,28,33,46.0,54.0
14.981308411214954,107,52,55,49.0,51.0
11.644444444444444,45,19,26,42.0,58.0
18.75,76,16,60,21.0,79.0
19.08421052631579,95,34,61,36.0,64.0
18.63302752293578,109,35,74,32.0,68.0
15.647058823529411,85,32,53,38.0,62.0
23.818181818181817,88,39,49,44.0,56.0
28.019417475728154,103,35,68,34.0,66.0
21.477941176470587,136,53,83,39.0,61.0
45.58914728682171,129,47,82,36.0,64.0
18.529411764705884,119,43,76,36.0,64.0
19.817460317460316,126,48,78,38.0,62.0
27.694444444444443,72,20,52,28.0,72.0
44.32857142857143,70,16,54,23.0,77.0
36.506493506493506,77,21,56,27.0,73.0
24.258064516129032,31,9,22,29.0,71.0
19.86842105263158,38,5,33,13.0,87.0
29.725,40,9,31,22.0,78.0
41.84615384615385,13,1,12,8.0,92.0
169.28571428571428,7,2,5,29.0,71.0
34.0,3,2,1,67.0,33.0
16.0,2,0,2,0.0,100.0
10.625,8,3,5,38.0,62.0
8.294117647058824,17,5,12,29.0,71.0
21.405405405405407,37,18,19,49.0,51.0
20.133333333333333,60,21,39,35.0,65.0
39.78082191780822,73,18,55,25.0,75.0
36.31192660550459,109,23,86,21.0,79.0
31.810650887573964,169,38,131,22.0,78.0
29.782608695652176,161,30,131,19.0,81.0
30.185185185185187,189,33,156,17.0,83.0
26.80625,160,34,126,21.0,79.0
28.413533834586467,133,24,109,18.0,82.0
22.6875,80,17,63,21.0,79.0
18.96153846153846,78,17,61,22.0,78.0
32.028301886792455,106,37,69,35.0,65.0
37.193548387096776,93,24,69,26.0,74.0
19.80952380952381,84,22,62,26.0,74.0
18.352941176470587,68,19,49,28.0,72.0
25.886363636363637,44,7,37,16.0,84.0
22.035714285714285,28,16,12,57.0,43.0
20.375,24,9,15,38.0,62.0
26.1,10,3,7,30.0,70.0
35.5,2,0,2,0.0,100.0
30.666666666666668,3,1,2,33.0,67.0
234.0,3,1,2,33.0,67.0
9.0,8,3,5,38.0,62.0
40.0,17,4,13,24.0,76.0
23.08108108108108,37,12,25,32.0,68.0
29.609756097560975,82,23,59,28.0,72.0
29.304,125,22,103,18.0,82.0
29.78985507246377,138,25,113,18.0,82.0
24.782608695652176,115,29,86,25.0,75.0
35.25547445255474,137,35,102,26.0,74.0
28.795180722891565,166,31,135,19.0,81.0
27.109756097560975,164,28,136,17.0,83.0
22.26751592356688,157,43,114,27.0,73.0
15.884297520661157,121,31,90,26.0,74.0
11.78125,32,11,21,34.0,66.0
18.586206896551722,29,8,21,28.0,72.0
19.543478260869566,46,17,29,37.0,63.0
17.22222222222222,36,9,27,25.0,75.0
22.85185185185185,27,20,7,74.0,26.0
51.05555555555556,18,5,13,28.0,72.0
34.38461538461539,13,2,11,15.0,85.0
39.583333333333336,12,0,12,0.0,100.0
52.75,4,1,3,25.0,75.0
5.5,4,0,4,0.0,100.0
10.333333333333334,3,3,0,100.0,0.0
7.461538461538462,13,10,3,77.0,23.0
10.818181818181818,11,4,7,36.0,64.0
16.272727272727273,55,25,30,45.0,55.0
15.363636363636363,99,48,51,48.0,52.0
19.95744680851064,47,17,30,36.0,64.0
24.266666666666666,75,24,51,32.0,68.0
23.58252427184466,103,23,80,22.0,78.0
17.505494505494507,91,34,57,37.0,63.0
22.08888888888889,90,30,60,33.0,67.0
24.06382978723404,94,24,70,26.0,74.0
16.485981308411215,107,27,80,25.0,75.0
16.296610169491526,118,47,71,40.0,60.0
15.849315068493151,146,65,81,45.0,55.0
16.71551724137931,116,51,65,44.0,56.0
20.053097345132745,113,36,77,32.0,68.0
24.155339805825243,103,37,66,36.0,64.0
59.73972602739726,73,15,58,21.0,79.0
76.71428571428571,35,14,21,40.0,60.0
23.96875,32,11,21,34.0,66.0
20.833333333333332,18,6,12,33.0,67.0
23.25,12,2,10,17.0,83.0
169.33333333333334,9,3,6,33.0,67.0
13.25,4,4,0,100.0,0.0
33.142857142857146,7,5,2,71.0,29.0
16.357142857142858,14,6,8,43.0,57.0
10.38888888888889,18,9,9,50.0,50.0
13.841269841269842,63,33,30,52.0,48.0
10.81651376146789,109,49,60,45.0,55.0
12.575757575757576,66,27,39,41.0,59.0
21.626666666666665,75,32,43,43.0,57.0
26.458715596330276,109,38,71,35.0,65.0
24.267857142857142,112,47,65,42.0,58.0
23.873949579831933,119,43,76,36.0,64.0
20.926470588235293,68,23,45,34.0,66.0
19.925,120,39,81,32.0,68.0
19.422764227642276,123,47,76,38.0,62.0
28.824858757062145,177,52,125,29.0,71.0
17.142857142857142,161,57,104,35.0,65.0
22.763513513513512,148,45,103,30.0,70.0
24.096491228070175,114,32,82,28.0,72.0
48.0735294117647,68,15,53,22.0,78.0
30.49206349206349,63,10,53,16.0,84.0
24.62857142857143,35,11,24,31.0,69.0
26.0,32,7,25,22.0,78.0
8.333333333333334,6,2,4,33.0,67.0
19.0,3,3,0,100.0,0.0
22.0,1,0,1,0.0,100.0
7.666666666666667,3,1,2,33.0,67.0
7.0,9,6,3,67.0,33.0
13.606060606060606,33,13,20,39.0,61.0
13.478260869565217,69,30,39,43.0,57.0
16.223214285714285,112,57,55,51.0,49.0
24.075,80,24,56,30.0,70.0
23.753846153846155,65,22,43,34.0,66.0
21.608695652173914,69,30,39,43.0,57.0
24.542168674698797,83,29,54,35.0,65.0
24.70408163265306,98,31,67,32.0,68.0
19.0125,80,26,54,32.0,68.0
16.430379746835442,79,31,48,39.0,61.0
20.5,120,49,71,41.0,59.0
20.089820359281436,167,69,98,41.0,59.0
19.37984496124031,129,50,79,39.0,61.0
20.02857142857143,105,33,72,31.0,69.0
21.228915662650603,83,20,63,24.0,76.0
17.11320754716981,53,13,40,25.0,75.0
24.342105263157894,38,8,30,21.0,79.0
28.857142857142858,28,6,22,21.0,79.0
14.625,16,8,8,50.0,50.0
11.928571428571429,14,11,3,79.0,21.0
17.333333333333332,6,2,4,33.0,67.0
10.0,1,1,0,100.0,0.0
16.0,7,3,4,43.0,57.0
18.416666666666668,12,8,4,67.0,33.0
11.791666666666666,24,11,13,46.0,54.0
11.170212765957446,47,24,23,51.0,49.0
11.0,65,36,29,55.0,45.0
16.854545454545455,55,22,33,40.0,60.0
32.689655172413794,58,28,30,48.0,52.0
20.43661971830986,71,27,44,38.0,62.0
21.83116883116883,77,28,49,36.0,64.0
21.65714285714286,105,40,65,38.0,62.0
23.47222222222222,108,37,71,34.0,66.0
21.168141592920353,113,47,66,42.0,58.0
21.413793103448278,116,39,77,34.0,66.0
18.376712328767123,146,55,91,38.0,62.0
17.3203125,128,49,79,38.0,62.0
23.14814814814815,108,34,74,31.0,69.0
20.265822784810126,79,26,53,33.0,67.0
29.785714285714285,70,11,59,16.0,84.0
21.05263157894737,57,17,40,30.0,70.0
42.903225806451616,31,8,23,26.0,74.0
21.74074074074074,27,5,22,19.0,81.0
28.0,8,3,5,38.0,62.0
29.0,1,1,0,100.0,0.0
18.0,2,1,1,50.0,50.0
25.6,5,3,2,60.0,40.0
13.076923076923077,13,6,7,46.0,54.0
21.37037037037037,27,11,16,41.0,59.0
13.826086956521738,69,28,41,41.0,59.0
12.2375,80,37,43,46.0,54.0
14.703703703703704,54,24,30,44.0,56.0
22.885245901639344,61,23,38,38.0,62.0
27.103092783505154,97,23,74,24.0,76.0
16.063063063063062,111,33,78,30.0,70.0
33.8134328358209,134,44,90,33.0,67.0
26.055118110236222,127,29,98,23.0,77.0
23.46783625730994,171,35,136,20.0,80.0
20.258992805755394,139,36,103,26.0,74.0
30.419354838709676,186,56,130,30.0,70.0
22.98581560283688,141,43,98,30.0,70.0
28.517543859649123,114,27,87,24.0,76.0
21.24074074074074,108,18,90,17.0,83.0
21.52112676056338,71,21,50,30.0,70.0
14.770833333333334,48,16,32,33.0,67.0
21.757575757575758,33,13,20,39.0,61.0
23.3,20,7,13,35.0,65.0
13.222222222222221,18,8,10,44.0,56.0
17.785714285714285,14,6,8,43.0,57.0
37.55555555555556,9,6,3,67.0,33.0
17.333333333333332,3,2,1,67.0,33.0
28.75,8,4,4,50.0,50.0
7.181818181818182,11,5,6,45.0,55.0
34.64,25,9,16,36.0,64.0
17.30952380952381,42,21,21,50.0,50.0
22.73076923076923,78,23,55,29.0,71.0
21.978947368421053,95,21,74,22.0,78.0
36.869565217391305,115,22,93,19.0,81.0
44.160714285714285,168,24,144,14.0,86.0
37.38532110091743,218,24,194,11.0,89.0
36.170103092783506,194,26,168,13.0,87.0
39.86144578313253,166,27,139,16.0,84.0
31.512562814070353,199,23,176,12.0,88.0
51.540983606557376,183,29,154,16.0,84.0
62.921951219512195,205,30,175,15.0,85.0
95.05069124423963,217,24,193,11.0,89.0
71.69934640522875,153,20,133,13.0,87.0
43.333333333333336,123,22,101,18.0,82.0
34.397260273972606,73,13,60,18.0,82.0
38.125,64,5,59,8.0,92.0
24.23404255319149,47,4,43,9.0,91.0
54.19047619047619,21,3,18,14.0,86.0
31.9375,16,3,13,19.0,81.0
25.75,4,1,3,25.0,75.0
38.142857142857146,7,2,5,29.0,71.0
11.8,5,2,3,40.0,60.0
10.4,15,11,4,73.0,27.0
21.291666666666668,24,11,13,46.0,54.0
12.948717948717949,39,17,22,44.0,56.0
36.76923076923077,78,20,58,26.0,74.0
33.69642857142857,112,19,93,17.0,83.0
45.22962962962963,135,26,109,19.0,81.0
49.424731182795696,186,30,156,16.0,84.0
34.96236559139785,186,24,162,13.0,87.0
34.50675675675676,148,29,119,20.0,80.0
32.054054054054056,148,26,122,18.0,82.0
31.22818791946309,149,16,133,11.0,89.0
29.125827814569536,151,22,129,15.0,85.0
35.32631578947368,95,19,76,20.0,80.0
21.9390243902439,82,19,63,23.0,77.0
25.61904761904762,105,29,76,28.0,72.0
48.98684210526316,76,14,62,18.0,82.0
24.82758620689655,29,8,21,28.0,72.0
45.7037037037037,27,7,20,26.0,74.0
22.666666666666668,9,1,8,11.0,89.0
38.857142857142854,7,0,7,0.0,100.0
22.6,5,2,3,40.0,60.0
5.333333333333333,3,2,1,67.0,33.0
6.0,5,4,1,80.0,20.0
7.923076923076923,13,9,4,69.0,31.0
12.15,20,8,12,40.0,60.0
10.479166666666666,48,14,34,29.0,71.0
11.97,100,51,49,51.0,49.0
12.857142857142858,56,28,28,50.0,50.0
16.736842105263158,57,22,35,39.0,61.0
24.40776699029126,103,33,70,32.0,68.0
15.465346534653465,101,32,69,32.0,68.0
28.71551724137931,116,32,84,28.0,72.0
18.07563025210084,119,33,86,28.0,72.0
18.076923076923077,91,31,60,34.0,66.0
17.854368932038835,103,41,62,40.0,60.0
16.757894736842104,190,63,127,33.0,67.0
22.75,144,43,101,30.0,70.0
24.904761904761905,105,35,70,33.0,67.0
19.53012048192771,83,26,57,31.0,69.0
10.69767441860465,43,16,27,37.0,63.0
18.4,40,9,31,22.0,78.0
29.61111111111111,36,5,31,14.0,86.0
21.3,20,8,12,40.0,60.0
33.6,5,3,2,60.0,40.0
2.0,1,0,1,0.0,100.0
35.0,1,1,0,100.0,0.0
8.6,5,2,3,40.0,60.0
11.1875,16,11,5,69.0,31.0
11.058823529411764,34,15,19,44.0,56.0
11.044117647058824,68,34,34,50.0,50.0
13.66,100,55,45,55.0,45.0
16.939393939393938,66,29,37,44.0,56.0
16.266666666666666,60,21,39,35.0,65.0
27.904761904761905,84,22,62,26.0,74.0
22.294736842105262,95,24,71,25.0,75.0
24.53153153153153,111,40,71,36.0,64.0
22.276923076923076,130,41,89,32.0,68.0
24.758333333333333,120,38,82,32.0,68.0
49.31612903225806,155,41,114,26.0,74.0
19.39877300613497,163,67,96,41.0,59.0
17.756302521008404,119,40,79,34.0,66.0
24.363636363636363,99,27,72,27.0,73.0
18.833333333333332,78,30,48,38.0,62.0
20.77358490566038,53,14,39,26.0,74.0
40.575,40,10,30,25.0,75.0
23.321428571428573,28,7,21,25.0,75.0
40.294117647058826,17,5,12,29.0,71.0
16.75,4,3,1,75.0,25.0
32.8,5,2,3,40.0,60.0
9.666666666666666,3,1,2,33.0,67.0
8.25,4,0,4,0.0,100.0
7.1,10,6,4,60.0,40.0
10.944444444444445,36,18,18,50.0,50.0
13.0,63,31,32,49.0,51.0
11.456521739130435,92,47,45,51.0,49.0
16.681159420289855,69,32,37,46.0,54.0
27.785714285714285,56,18,38,32.0,68.0
26.847826086956523,92,32,60,35.0,65.0
24.72826086956522,92,26,66,28.0,72.0
22.314606741573034,89,33,56,37.0,63.0
34.18556701030928,97,29,68,30.0,70.0
28.22222222222222,117,35,82,30.0,70.0
18.216783216783217,143,55,88,38.0,62.0
16.091549295774648,142,57,85,40.0,60.0
20.87878787878788,132,43,89,33.0,67.0
19.589285714285715,56,18,38,32.0,68.0
17.196969696969695,66,22,44,33.0,67.0
21.366197183098592,71,26,45,37.0,63.0
11.808510638297872,47,17,30,36.0,64.0
14.422222222222222,45,18,27,40.0,60.0
16.0,21,5,16,24.0,76.0
10.7,10,5,5,50.0,50.0
8.0,3,0,3,0.0,100.0
16.0,2,1,1,50.0,50.0
76.16666666666667,6,4,2,67.0,33.0
11.88888888888889,9,4,5,44.0,56.0
6.764705882352941,17,9,8,53.0,47.0
15.854545454545455,55,22,33,40.0,60.0
14.50561797752809,89,40,49,45.0,55.0
18.573333333333334,75,29,46,39.0,61.0
20.788732394366196,71,21,50,30.0,70.0
19.513513513513512,74,24,50,32.0,68.0
17.78688524590164,122,39,83,32.0,68.0
16.295238095238094,105,35,70,33.0,67.0
63.60909090909091,110,34,76,31.0,69.0
26.348214285714285,112,37,75,33.0,67.0
18.518796992481203,133,44,89,33.0,67.0
26.117977528089888,178,68,110,38.0,62.0
22.64666666666667,150,33,117,22.0,78.0
19.941747572815533,103,27,76,26.0,74.0
18.622222222222224,90,23,67,26.0,74.0
26.40506329113924,79,22,57,28.0,72.0
11.48936170212766,47,13,34,28.0,72.0
16.68,25,11,14,44.0,56.0
37.80952380952381,21,6,15,29.0,71.0
4.0,5,3,2,60.0,40.0
16.25,4,2,2,50.0,50.0
33.0,3,1,2,33.0,67.0
36.25,4,1,3,25.0,75.0
5.909090909090909,11,5,6,45.0,55.0
7.071428571428571,28,17,11,61.0,39.0
12.542857142857143,70,28,42,40.0,60.0
12.5,100,42,58,42.0,58.0
18.252747252747252,91,28,63,31.0,69.0
27.36904761904762,84,21,63,25.0,75.0
23.427350427350426,117,25,92,21.0,79.0
18.735849056603772,159,50,109,31.0,69.0
34.208955223880594,134,35,99,26.0,74.0
35.136986301369866,146,29,117,20.0,80.0
27.345454545454544,165,33,132,20.0,80.0
21.433734939759034,166,48,118,29.0,71.0
19.071065989847718,197,54,143,27.0,73.0
19.774193548387096,155,39,116,25.0,75.0
24.471014492753625,138,31,107,22.0,78.0
27.671875,128,28,100,22.0,78.0
20.976470588235294,85,26,59,31.0,69.0
21.3,100,22,78,22.0,78.0
20.38095238095238,63,9,54,14.0,86.0
16.96153846153846,26,2,24,8.0,92.0
20.61904761904762,21,6,15,29.0,71.0
16.733333333333334,15,6,9,40.0,60.0
19.0,1,1,0,100.0,0.0
16.875,8,1,7,12.0,88.0
6.6,5,3,2,60.0,40.0
4.666666666666667,3,2,1,67.0,33.0
6.375,8,0,8,0.0,100.0
14.666666666666666,24,6,18,25.0,75.0
17.314285714285713,35,9,26,26.0,74.0
26.507042253521128,71,19,52,27.0,73.0
30.725806451612904,62,11,51,18.0,82.0
26.15625,128,27,101,21.0,79.0
42.0440251572327,159,16,143,10.0,90.0
32.21176470588235,170,24,146,14.0,86.0
42.562130177514796,169,29,140,17.0,83.0
35.73076923076923,156,12,144,8.0,92.0
51.15384615384615,143,30,113,21.0,79.0
28.556338028169016,142,28,114,20.0,80.0
25.236641221374047,131,23,108,18.0,82.0
42.857142857142854,119,24,95,20.0,80.0
76.45871559633028,109,21,88,19.0,81.0
61.25,76,19,57,25.0,75.0
31.0,54,5,49,9.0,91.0
53.55555555555556,27,2,25,7.0,93.0
40.58064516129032,31,4,27,13.0,87.0
21.25,12,3,9,25.0,75.0
106.0,5,2,3,40.0,60.0
16.0,2,0,2,0.0,100.0
11.0,1,0,1,0.0,100.0
10.6,10,5,5,50.0,50.0
7.785714285714286,14,7,7,50.0,50.0
28.638297872340427,47,10,37,21.0,79.0
29.42222222222222,45,7,38,16.0,84.0
31.04854368932039,103,24,79,23.0,77.0
28.69298245614035,114,28,86,25.0,75.0
30.38135593220339,118,33,85,28.0,72.0
29.5,138,17,121,12.0,88.0
29.294416243654823,197,32,165,16.0,84.0
26.83783783783784,185,20,165,11.0,89.0
33.322274881516584,211,17,194,8.0,92.0
31.721212121212123,165,23,142,14.0,86.0
33.794701986754966,151,18,133,12.0,88.0
23.63063063063063,111,21,90,19.0,81.0
27.91176470588235,102,21,81,21.0,79.0
36.38333333333333,60,9,51,15.0,85.0
17.466666666666665,30,6,24,20.0,80.0
16.2,15,2,13,13.0,87.0
28.90909090909091,11,1,10,9.0,91.0
26.0,4,0,4,0.0,100.0
17.5,2,0,2,0.0,100.0
223.0,1,1,0,100.0,0.0
16.0,7,2,5,29.0,71.0
13.0,9,6,3,67.0,33.0
14.578947368421053,19,7,12,37.0,63.0
11.547169811320755,53,23,30,43.0,57.0
12.76923076923077,91,33,58,36.0,64.0
16.267605633802816,71,15,56,21.0,79.0
21.946428571428573,56,11,45,20.0,80.0
22.166666666666668,54,18,36,33.0,67.0
17.387096774193548,93,33,60,35.0,65.0
22.0,98,23,75,23.0,77.0
26.445544554455445,101,23,78,23.0,77.0
24.8984375,128,25,103,20.0,80.0
26.0381679389313,131,50,81,38.0,62.0
19.39072847682119,151,52,99,34.0,66.0
18.492753623188406,138,35,103,25.0,75.0
23.78787878787879,99,28,71,28.0,72.0
17.726027397260275,73,23,50,32.0,68.0
19.46969696969697,66,12,54,18.0,82.0
12.304347826086957,23,11,12,48.0,52.0
23.928571428571427,14,4,10,29.0,71.0
30.8125,16,4,12,25.0,75.0
4.0,3,1,2,33.0,67.0
24.8,5,0,5,0.0,100.0
98.5,2,2,0,100.0,0.0
17.2,5,2,3,40.0,60.0
7.923076923076923,13,6,7,46.0,54.0
13.666666666666666,27,16,11,59.0,41.0
10.101449275362318,69,26,43,38.0,62.0
11.73913043478261,92,33,59,36.0,64.0
16.916666666666668,72,35,37,49.0,51.0
22.319444444444443,72,18,54,25.0,75.0
20.295454545454547,88,22,66,25.0,75.0
26.5,106,26,80,25.0,75.0
32.234693877551024,98,29,69,30.0,70.0
30.601769911504423,113,24,89,21.0,79.0
33.13223140495868,121,31,90,26.0,74.0
24.916666666666668,132,32,100,24.0,76.0
19.720496894409937,161,50,111,31.0,69.0
22.395833333333332,144,28,116,19.0,81.0
21.362068965517242,116,27,89,23.0,77.0
21.3,90,28,62,31.0,69.0
25.197674418604652,86,17,69,20.0,80.0
13.74074074074074,54,15,39,28.0,72.0
32.21739130434783,46,8,38,17.0,83.0
20.941176470588236,34,7,27,21.0,79.0
17.0,11,4,7,36.0,64.0
22.833333333333332,6,2,4,33.0,67.0
50.333333333333336,3,1,2,33.0,67.0
17.0,2,0,2,0.0,100.0
66.41666666666667,12,4,8,33.0,67.0
15.875,16,5,11,31.0,69.0
19.846153846153847,13,4,9,31.0,69.0
21.875,40,13,27,32.0,68.0
23.86111111111111,72,18,54,25.0,75.0
43.860759493670884,79,15,64,19.0,81.0
31.63157894736842,95,19,76,20.0,80.0
30.985714285714284,140,18,122,13.0,87.0
26.05732484076433,157,19,138,12.0,88.0
32.50970873786408,206,17,189,8.0,92.0
27.879227053140095,207,41,166,20.0,80.0
30.92168674698795,166,24,142,14.0,86.0
38.673202614379086,153,16,137,10.0,90.0
21.75,104,25,79,24.0,76.0
23.830188679245282,159,16,143,10.0,90.0
26.383561643835616,146,28,118,19.0,81.0
24.805825242718445,206,32,174,16.0,84.0
29.77720207253886,193,36,157,19.0,81.0
18.52173913043478,92,18,74,20.0,80.0
23.783783783783782,37,8,29,22.0,78.0
31.944444444444443,18,6,12,33.0,67.0
33.22222222222222,9,5,4,56.0,44.0
2.5,2,2,0,100.0,0.0
5.333333333333333,6,4,2,67.0,33.0
32.55555555555556,9,6,3,67.0,33.0
13.041666666666666,24,8,16,33.0,67.0
12.615384615384615,39,8,31,21.0,79.0
13.287128712871286,101,40,61,40.0,60.0
24.52238805970149,67,18,49,27.0,73.0
22.123287671232877,73,9,64,12.0,88.0
25.6,95,21,74,22.0,78.0
27.62,150,35,115,23.0,77.0
38.392405063291136,158,36,122,23.0,77.0
26.041666666666668,144,19,125,13.0,87.0
31.47787610619469,113,25,88,22.0,78.0
22.82051282051282,156,36,120,23.0,77.0
19.83431952662722,169,47,122,28.0,72.0
18.986928104575163,153,30,123,20.0,80.0
23.14074074074074,135,24,111,18.0,82.0
22.87962962962963,108,23,85,21.0,79.0
25.195402298850574,87,31,56,36.0,64.0
24.703125,64,17,47,27.0,73.0
17.341463414634145,41,9,32,22.0,78.0
10.1,10,6,4,60.0,40.0
11.3,10,2,8,20.0,80.0
116.66666666666667,3,3,0,100.0,0.0
40.0,1,1,0,100.0,0.0
25.714285714285715,7,5,2,71.0,29.0
9.222222222222221,9,5,4,56.0,44.0
10.74074074074074,27,9,18,33.0,67.0
18.685185185185187,54,21,33,39.0,61.0
13.056603773584905,106,40,66,38.0,62.0
23.395833333333332,96,22,74,23.0,77.0
30.98095238095238,105,20,85,19.0,81.0
28.67391304347826,138,35,103,25.0,75.0
21.424778761061948,113,18,95,16.0,84.0
25.741496598639454,147,26,121,18.0,82.0
29.852564102564102,156,29,127,19.0,81.0
22.660493827160494,162,31,131,19.0,81.0
21.770114942528735,174,43,131,25.0,75.0
28.529411764705884,187,47,140,25.0,75.0
24.167630057803468,173,38,135,22.0,78.0
22.677165354330707,127,24,103,19.0,81.0
24.19463087248322,149,28,121,19.0,81.0
24.912,125,30,95,24.0,76.0
43.32692307692308,104,12,92,12.0,88.0
41.37931034482759,87,11,76,13.0,87.0
21.543478260869566,46,10,36,22.0,78.0
28.55,20,2,18,10.0,90.0
24.875,8,4,4,50.0,50.0
3.0,2,1,1,50.0,50.0
13.5,2,1,1,50.0,50.0
9.4,10,2,8,20.0,80.0
19.533333333333335,15,6,9,40.0,60.0
17.11764705882353,17,7,10,41.0,59.0
20.186046511627907,43,13,30,30.0,70.0
18.39240506329114,79,20,59,25.0,75.0
25.50420168067227,119,31,88,26.0,74.0
30.72159090909091,176,23,153,13.0,87.0
25.8268156424581,179,30,149,17.0,83.0
32.58522727272727,176,29,147,16.0,84.0
32.30384615384615,260,45,215,17.0,83.0
34.590090090090094,222,30,192,14.0,86.0
28.82439024390244,205,40,165,20.0,80.0
23.920212765957448,188,27,161,14.0,86.0
26.265193370165747,181,16,165,9.0,91.0
23.34722222222222,144,25,119,17.0,83.0
21.87313432835821,134,28,106,21.0,79.0
23.861386138613863,101,23,78,23.0,77.0
14.068627450980392,102,29,73,28.0,72.0
32.64473684210526,76,14,62,18.0,82.0
21.357142857142858,28,3,25,11.0,89.0
12.782608695652174,23,5,18,22.0,78.0
27.727272727272727,11,3,8,27.0,73.0
18.0,3,2,1,67.0,33.0
3.4285714285714284,7,6,1,86.0,14.0
13.125,8,6,2,75.0,25.0
6.96,25,14,11,56.0,44.0
11.11111111111111,18,10,8,56.0,44.0
36.75757575757576,66,21,45,32.0,68.0
26.59375,64,19,45,30.0,70.0
31.428571428571427,91,16,75,18.0,82.0
34.220689655172414,145,21,124,14.0,86.0
36.30201342281879,149,18,131,12.0,88.0
35.54304635761589,151,17,134,11.0,89.0
25.282608695652176,184,25,159,14.0,86.0
28.18888888888889,180,34,146,19.0,81.0
25.708571428571428,175,32,143,18.0,82.0
26.65730337078652,178,22,156,12.0,88.0
23.019417475728154,103,19,84,18.0,82.0
25.760416666666668,96,18,78,19.0,81.0
24.16867469879518,83,21,62,25.0,75.0
21.357142857142858,70,15,55,21.0,79.0
28.45,40,6,34,15.0,85.0
18.38095238095238,21,7,14,33.0,67.0
20.75,12,1,11,8.0,92.0
22.428571428571427,7,2,5,29.0,71.0
92.0,2,0,2,0.0,100.0
5.0,1,0,1,0.0,100.0
7.666666666666667,3,2,1,67.0,33.0
17.9,10,5,5,50.0,50.0
11.409090909090908,22,9,13,41.0,59.0
11.475,80,28,52,35.0,65.0
12.467289719626168,107,38,69,36.0,64.0
19.040816326530614,49,14,35,29.0,71.0
34.205479452054796,73,19,54,26.0,74.0
23.226666666666667,75,27,48,36.0,64.0
21.84269662921348,89,26,63,29.0,71.0
31.51063829787234,94,30,64,32.0,68.0
24.0,89,18,71,20.0,80.0
24.3359375,128,36,92,28.0,72.0
18.213333333333335,150,50,100,33.0,67.0
16.877551020408163,147,47,100,32.0,68.0
15.178861788617887,123,36,87,29.0,71.0
18.419753086419753,81,22,59,27.0,73.0
20.984126984126984,63,20,43,32.0,68.0
14.478260869565217,46,16,30,35.0,65.0
21.678571428571427,28,8,20,29.0,71.0
64.11363636363636,44,3,41,7.0,93.0
179.5,18,3,15,17.0,83.0
11.2,5,2,3,40.0,60.0
9.5,2,2,0,100.0,0.0
55.5,2,1,1,50.0,50.0
6.4,5,2,3,40.0,60.0
6.157894736842105,19,13,6,68.0,32.0
8.68,25,16,9,64.0,36.0
10.75,64,24,40,38.0,62.0
11.026785714285714,112,47,65,42.0,58.0
13.0125,80,32,48,40.0,60.0
26.0,70,25,45,36.0,64.0
26.159574468085108,94,35,59,37.0,63.0
28.753086419753085,81,24,57,30.0,70.0
28.296610169491526,118,26,92,22.0,78.0
35.2,100,22,78,22.0,78.0
23.26530612244898,98,26,72,27.0,73.0
18.23015873015873,126,47,79,37.0,63.0
20.611464968152866,157,45,112,29.0,71.0
24.12837837837838,148,53,95,36.0,64.0
22.637096774193548,124,45,79,36.0,64.0
19.983193277310924,119,38,81,32.0,68.0
23.96153846153846,78,19,59,24.0,76.0
24.051724137931036,58,11,47,19.0,81.0
13.15,20,9,11,45.0,55.0
27.636363636363637,11,2,9,18.0,82.0
16.357142857142858,14,4,10,29.0,71.0
1.5,2,1,1,50.0,50.0
14.4,5,1,4,20.0,80.0
7.75,4,1,3,25.0,75.0
21.5625,16,9,7,56.0,44.0
9.085714285714285,35,13,22,37.0,63.0
11.344827586206897,87,38,49,44.0,56.0
12.018018018018019,111,43,68,39.0,61.0
15.293103448275861,58,23,35,40.0,60.0
19.789473684210527,57,16,41,28.0,72.0
31.243243243243242,74,23,51,31.0,69.0
22.02469135802469,81,16,65,20.0,80.0
30.658227848101266,79,27,52,34.0,66.0
26.50793650793651,126,24,102,19.0,81.0
23.946428571428573,112,31,81,28.0,72.0
23.369565217391305,138,45,93,33.0,67.0
17.794520547945204,146,52,94,36.0,64.0
29.620689655172413,145,45,100,31.0,69.0
24.93798449612403,129,41,88,32.0,68.0
32.96078431372549,102,32,70,31.0,69.0
21.38,100,30,70,30.0,70.0
15.822222222222223,45,13,32,29.0,71.0
33.7027027027027,37,11,26,30.0,70.0
12.0,12,2,10,17.0,83.0
38.8,10,2,8,20.0,80.0
17.125,8,0,8,0.0,100.0
68.75,4,1,3,25.0,75.0
15.333333333333334,6,2,4,33.0,67.0
20.352941176470587,17,9,8,53.0,47.0
8.511627906976743,43,16,27,37.0,63.0
31.864864864864863,74,22,52,30.0,70.0
24.587719298245613,114,48,66,42.0,58.0
48.5,72,26,46,36.0,64.0
22.392857142857142,84,27,57,32.0,68.0
20.862068965517242,87,26,61,30.0,70.0
24.8,115,41,74,36.0,64.0
22.38095238095238,105,28,77,27.0,73.0
21.577464788732396,71,24,47,34.0,66.0
21.824074074074073,108,36,72,33.0,67.0
18.142857142857142,140,43,97,31.0,69.0
16.091603053435115,131,40,91,31.0,69.0
54.17985611510792,139,48,91,35.0,65.0
19.932692307692307,104,42,62,40.0,60.0
25.401785714285715,112,31,81,28.0,72.0
16.973333333333333,75,25,50,33.0,67.0
17.580645161290324,62,21,41,34.0,66.0
32.891304347826086,46,13,33,28.0,72.0
13.538461538461538,13,3,10,23.0,77.0
27.76923076923077,13,4,9,31.0,69.0
42.0,7,1,6,14.0,86.0
12.5,4,1,3,25.0,75.0
22.2,5,3,2,60.0,40.0
7.333333333333333,12,8,4,67.0,33.0
10.625,32,12,20,38.0,62.0
11.016129032258064,62,28,34,45.0,55.0
10.8348623853211,109,38,71,35.0,65.0
21.88679245283019,53,14,39,26.0,74.0
21.18867924528302,53,13,40,25.0,75.0
20.985714285714284,70,16,54,23.0,77.0
47.566265060240966,83,30,53,36.0,64.0
20.142857142857142,98,21,77,21.0,79.0
21.223300970873787,103,25,78,24.0,76.0
20.42016806722689,119,33,86,28.0,72.0
21.511811023622048,127,39,88,31.0,69.0
21.626666666666665,150,53,97,35.0,65.0
18.975206611570247,121,36,85,30.0,70.0
30.931623931623932,117,40,77,34.0,66.0
28.404580152671755,131,38,93,29.0,71.0
32.28048780487805,82,31,51,38.0,62.0
23.40277777777778,72,21,51,29.0,71.0
25.115384615384617,78,13,65,17.0,83.0
17.319148936170212,47,13,34,28.0,72.0
19.916666666666668,36,21,15,58.0,42.0
21.764705882352942,17,6,11,35.0,65.0
44.75,8,4,4,50.0,50.0
10.0,2,1,1,50.0,50.0
24.8,5,4,1,80.0,20.0
31.083333333333332,12,3,9,25.0,75.0
13.130434782608695,23,5,18,22.0,78.0
90.27118644067797,59,20,39,34.0,66.0
26.343434343434343,99,24,75,24.0,76.0
29.14457831325301,83,25,58,30.0,70.0
36.855172413793106,145,27,118,19.0,81.0
28.934306569343065,137,33,104,24.0,76.0
27.686131386861312,137,27,110,20.0,80.0
33.78735632183908,174,39,135,22.0,78.0
22.24858757062147,177,34,143,19.0,81.0
24.734177215189874,158,38,120,24.0,76.0
24.866666666666667,135,26,109,19.0,81.0
25.992248062015506,129,30,99,23.0,77.0
38.71287128712871,101,26,75,26.0,74.0
21.587155963302752,109,28,81,26.0,74.0
22.595238095238095,84,19,65,23.0,77.0
22.802816901408452,71,18,53,25.0,75.0
20.015625,64,7,57,11.0,89.0
19.672131147540984,61,9,52,15.0,85.0
18.05,20,0,20,0.0,100.0
22.9375,16,0,16,0.0,100.0
28.5,8,2,6,25.0,75.0
35.166666666666664,6,1,5,17.0,83.0
90.5,6,3,3,50.0,50.0
10.647058823529411,17,9,8,53.0,47.0
12.136363636363637,44,22,22,50.0,50.0
18.24390243902439,41,16,25,39.0,61.0
32.648148148148145,54,19,35,35.0,65.0
25.847619047619048,105,28,77,27.0,73.0
30.103448275862068,116,21,95,18.0,82.0
29.646551724137932,116,22,94,19.0,81.0
34.74747474747475,99,30,69,30.0,70.0
22.779411764705884,136,26,110,19.0,81.0
38.65217391304348,138,26,112,19.0,81.0
23.884955752212388,113,28,85,25.0,75.0
27.01818181818182,110,27,83,25.0,75.0
21.647727272727273,88,23,65,26.0,74.0
61.60204081632653,98,25,73,26.0,74.0
28.123456790123456,81,22,59,27.0,73.0
26.973333333333333,75,22,53,29.0,71.0
22.333333333333332,87,23,64,26.0,74.0
25.069767441860463,43,18,25,42.0,58.0
16.857142857142858,14,5,9,36.0,64.0
18.333333333333332,9,2,7,22.0,78.0
18.0,2,1,1,50.0,50.0
9.0,1,1,0,100.0,0.0
6.2,5,3,2,60.0,40.0
13.25,12,5,7,42.0,58.0
10.714285714285714,21,11,10,52.0,48.0
14.681818181818182,66,24,42,36.0,64.0
15.91578947368421,95,33,62,35.0,65.0
18.058823529411764,85,34,51,40.0,60.0
26.935897435897434,78,31,47,40.0,60.0
31.080459770114942,87,18,69,21.0,79.0
23.153846153846153,117,34,83,29.0,71.0
18.50862068965517,116,36,80,31.0,69.0
23.805309734513273,113,32,81,28.0,72.0
18.25,88,29,59,33.0,67.0
41.65384615384615,104,33,71,32.0,68.0
21.79746835443038,158,50,108,32.0,68.0
18.655172413793103,145,54,91,37.0,63.0
23.69298245614035,114,40,74,35.0,65.0
22.97752808988764,89,21,68,24.0,76.0
26.419047619047618,105,22,83,21.0,79.0
15.326530612244898,49,14,35,29.0,71.0
17.73913043478261,23,4,19,17.0,83.0
54.285714285714285,14,3,11,21.0,79.0
22.928571428571427,14,7,7,50.0,50.0
11.083333333333334,12,11,1,92.0,8.0
25.666666666666668,3,3,0,100.0,0.0
7.2,5,3,2,60.0,40.0
6.928571428571429,14,7,7,50.0,50.0
13.181818181818182,33,10,23,30.0,70.0
20.826666666666668,75,30,45,40.0,60.0
15.666666666666666,114,40,74,35.0,65.0
19.22093023255814,86,33,53,38.0,62.0
31.50588235294118,85,25,60,29.0,71.0
19.313725490196077,102,40,62,39.0,61.0
23.234782608695653,115,40,75,35.0,65.0
19.78688524590164,122,40,82,33.0,67.0
27.623529411764707,85,35,50,41.0,59.0
17.792079207920793,101,33,68,33.0,67.0
21.387596899224807,129,56,73,43.0,57.0
18.429378531073446,177,70,107,40.0,60.0
24.541984732824428,131,44,87,34.0,66.0
20.546875,128,41,87,32.0,68.0
23.844827586206897,116,31,85,27.0,73.0
26.854368932038835,103,25,78,24.0,76.0
17.333333333333332,57,30,27,53.0,47.0
13.157894736842104,19,14,5,74.0,26.0
12.818181818181818,11,7,4,64.0,36.0
25.555555555555557,9,3,6,33.0,67.0
23.666666666666668,3,2,1,67.0,33.0
15.428571428571429,7,5,2,71.0,29.0
11.333333333333334,15,8,7,53.0,47.0
8.615384615384615,26,11,15,42.0,58.0
14.820512820512821,78,29,49,37.0,63.0
14.9921875,128,48,80,38.0,62.0
17.85185185185185,81,25,56,31.0,69.0
26.735294117647058,68,29,39,43.0,57.0
20.115384615384617,104,29,75,28.0,72.0
23.065217391304348,92,27,65,29.0,71.0
17.95967741935484,124,34,90,27.0,73.0
23.628318584070797,113,33,80,29.0,71.0
27.377551020408163,98,35,63,36.0,64.0
19.73722627737226,137,41,96,30.0,70.0
20.25,200,73,127,36.0,64.0
21.853658536585368,164,51,113,31.0,69.0
26.274647887323944,142,40,102,28.0,72.0
24.390625,128,36,92,28.0,72.0
21.161616161616163,99,27,72,27.0,73.0
27.38888888888889,72,22,50,31.0,69.0
22.40625,32,6,26,19.0,81.0
10.25,12,9,3,75.0,25.0
21.333333333333332,12,8,4,67.0,33.0
4.125,8,8,0,100.0,0.0
31.0,1,1,0,100.0,0.0
28.4,10,3,7,30.0,70.0
10.071428571428571,14,7,7,50.0,50.0
9.333333333333334,24,11,13,46.0,54.0
19.70149253731343,67,29,38,43.0,57.0
12.390625,128,52,76,41.0,59.0
19.577464788732396,71,30,41,42.0,58.0
25.07246376811594,69,20,49,29.0,71.0
20.305263157894736,95,32,63,34.0,66.0
34.216,125,43,82,34.0,66.0
21.824074074074073,108,44,64,41.0,59.0
27.753968253968253,126,50,76,40.0,60.0
32.82222222222222,135,45,90,33.0,67.0
17.91390728476821,151,51,100,34.0,66.0
25.94736842105263,209,63,146,30.0,70.0
26.94705882352941,170,62,108,36.0,64.0
25.22360248447205,161,57,104,35.0,65.0
24.638297872340427,94,22,72,23.0,77.0
26.414285714285715,70,20,50,29.0,71.0
19.30909090909091,55,15,40,27.0,73.0
17.28,25,13,12,52.0,48.0
9.411764705882353,17,6,11,35.0,65.0
20.2,15,3,12,20.0,80.0
13.0,1,1,0,100.0,0.0
5.5,2,1,1,50.0,50.0
11.166666666666666,6,4,2,67.0,33.0
7.5,8,3,5,38.0,62.0
9.709677419354838,31,20,11,65.0,35.0
13.933333333333334,75,34,41,45.0,55.0
16.61764705882353,102,31,71,30.0,70.0
39.51898734177215,79,25,54,32.0,68.0
23.571428571428573,63,25,38,40.0,60.0
33.273381294964025,139,39,100,28.0,72.0
29.72463768115942,138,33,105,24.0,76.0
28.84472049689441,161,31,130,19.0,81.0
32.57046979865772,149,40,109,27.0,73.0
29.57894736842105,152,38,114,25.0,75.0
21.145569620253166,158,47,111,30.0,70.0
22.48404255319149,188,48,140,26.0,74.0
23.763157894736842,152,39,113,26.0,74.0
33.016129032258064,124,30,94,24.0,76.0
23.8141592920354,113,35,78,31.0,69.0
29.303030303030305,66,12,54,18.0,82.0
16.76,75,26,49,35.0,65.0
27.473684210526315,57,15,42,26.0,74.0
26.725,40,6,34,15.0,85.0
24.866666666666667,15,4,11,27.0,73.0
17.666666666666668,9,5,4,56.0,44.0
6.857142857142857,7,1,6,14.0,86.0
17.666666666666668,3,1,2,33.0,67.0
7.8,5,2,3,40.0,60.0
15.0,11,4,7,36.0,64.0
18.03846153846154,26,10,16,38.0,62.0
23.51219512195122,41,8,33,20.0,80.0
18.721311475409838,61,15,46,25.0,75.0
22.27777777777778,126,26,100,21.0,79.0
29.427027027027027,185,38,147,21.0,79.0
27.443786982248522,169,34,135,20.0,80.0
26.242424242424242,231,36,195,16.0,84.0
28.6864406779661,236,39,197,17.0,83.0
24.12707182320442,181,40,141,22.0,78.0
24.899441340782122,179,29,150,16.0,84.0
24.623655913978496,186,32,154,17.0,83.0
38.31147540983606,183,56,127,31.0,69.0
25.26530612244898,147,26,121,18.0,82.0
26.79310344827586,145,35,110,24.0,76.0
31.134831460674157,89,17,72,19.0,81.0
28.25862068965517,116,27,89,23.0,77.0
28.653333333333332,75,15,60,20.0,80.0
37.35294117647059,34,15,19,44.0,56.0
27.794117647058822,34,9,25,26.0,74.0
22.5,8,1,7,12.0,88.0
28.666666666666668,3,2,1,67.0,33.0
50.25,8,2,6,25.0,75.0
13.6,5,3,2,60.0,40.0
35.25,12,4,8,33.0,67.0
35.08695652173913,23,8,15,35.0,65.0
42.21739130434783,46,18,28,39.0,61.0
29.726027397260275,73,20,53,27.0,73.0
41.93835616438356,146,27,119,18.0,82.0
53.524193548387096,248,42,206,17.0,83.0
50.139830508474574,236,56,180,24.0,76.0
38.646511627906975,215,36,179,17.0,83.0
41.79908675799087,219,49,170,22.0,78.0
29.867724867724867,189,30,159,16.0,84.0
22.44808743169399,183,36,147,20.0,80.0
24.8503937007874,127,24,103,19.0,81.0
27.82894736842105,152,41,111,27.0,73.0
29.816176470588236,136,29,107,21.0,79.0
26.5531914893617,94,28,66,30.0,70.0
34.013888888888886,72,20,52,28.0,72.0
20.17391304347826,46,14,32,30.0,70.0
24.307692307692307,39,14,25,36.0,64.0
25.8,15,5,10,33.0,67.0
36.375,8,5,3,62.0,38.0
4.0,1,0,1,0.0,100.0
10.0,1,0,1,0.0,100.0
9.714285714285714,7,3,4,43.0,57.0
9.5,14,7,7,50.0,50.0
72.22222222222223,27,12,15,44.0,56.0
13.17741935483871,62,22,40,35.0,65.0
21.595238095238095,84,34,50,40.0,60.0
18.44859813084112,107,32,75,30.0,70.0
42.320754716981135,53,24,29,45.0,55.0
21.0,70,23,47,33.0,67.0
22.682242990654206,107,32,75,30.0,70.0
26.560439560439562,91,21,70,23.0,77.0
18.010416666666668,96,43,53,45.0,55.0
17.901960784313726,102,32,70,31.0,69.0
18.6875,144,46,98,32.0,68.0
15.525316455696203,158,48,110,30.0,70.0
21.45985401459854,137,43,94,31.0,69.0
28.725806451612904,124,40,84,32.0,68.0
22.418367346938776,98,30,68,31.0,69.0
24.75,60,15,45,25.0,75.0
26.864406779661017,59,18,41,31.0,69.0
19.40909090909091,22,8,14,36.0,64.0
25.833333333333332,12,3,9,25.0,75.0
7.181818181818182,11,9,2,82.0,18.0
3.0,1,0,1,0.0,100.0
10.333333333333334,6,1,5,17.0,83.0
11.0,15,6,9,40.0,60.0
11.166666666666666,30,14,16,47.0,53.0
13.402298850574713,87,36,51,41.0,59.0
15.7,130,53,77,41.0,59.0
17.5,74,23,51,31.0,69.0
16.21875,64,24,40,38.0,62.0
24.25862068965517,116,41,75,35.0,65.0
14.672727272727272,110,36,74,33.0,67.0
26.958333333333332,72,34,38,47.0,53.0
25.012048192771083,83,27,56,33.0,67.0
31.569444444444443,72,33,39,46.0,54.0
20.316831683168317,101,41,60,41.0,59.0
17.46153846153846,130,43,87,33.0,67.0
19.93103448275862,87,26,61,30.0,70.0
26.641025641025642,78,20,58,26.0,74.0
30.53846153846154,52,21,31,40.0,60.0
26.46551724137931,58,22,36,38.0,62.0
12.689655172413794,29,10,19,34.0,66.0
11.785714285714286,14,8,6,57.0,43.0
26.7,20,8,12,40.0,60.0
13.714285714285714,7,1,6,14.0,86.0
5.0,2,2,0,100.0,0.0
13.333333333333334,3,1,2,33.0,67.0
7.0,1,0,1,0.0,100.0
19.428571428571427,14,6,8,43.0,57.0
11.678571428571429,28,12,16,43.0,57.0
15.408163265306122,49,21,28,43.0,57.0
15.4,90,46,44,51.0,49.0
14.132075471698114,53,14,39,26.0,74.0
26.63157894736842,57,21,36,37.0,63.0
18.415384615384614,65,25,40,38.0,62.0
24.863636363636363,88,34,54,39.0,61.0
15.576923076923077,78,27,51,35.0,65.0
25.066666666666666,60,20,40,33.0,67.0
17.53448275862069,58,27,31,47.0,53.0
17.55,80,27,53,34.0,66.0
17.23931623931624,117,48,69,41.0,59.0
27.714285714285715,98,39,59,40.0,60.0
19.147727272727273,88,38,50,43.0,57.0
26.21505376344086,93,38,55,41.0,59.0
21.281690140845072,71,33,38,46.0,54.0
30.770491803278688,61,13,48,21.0,79.0
22.47222222222222,36,12,24,33.0,67.0
29.555555555555557,9,3,6,33.0,67.0
37.5,2,0,2,0.0,100.0
30.333333333333332,3,1,2,33.0,67.0
27.25,4,0,4,0.0,100.0
43.666666666666664,3,0,3,0.0,100.0
11.444444444444445,9,4,5,44.0,56.0
8.333333333333334,27,13,14,48.0,52.0
17.675,40,17,23,42.0,57.0
16.094736842105263,95,40,55,42.0,58.0
16.859154929577464,71,25,46,35.0,65.0
16.673076923076923,52,21,31,40.0,60.0
16.625,80,28,52,35.0,65.0
21.580357142857142,112,18,94,16.0,84.0
13.773333333333333,75,29,46,39.0,61.0
24.333333333333332,81,39,42,48.0,52.0
19.395061728395063,81,28,53,35.0,65.0
34.32432432432432,111,47,64,42.0,58.0
14.333333333333334,114,45,69,39.0,61.0
19.115044247787612,113,32,81,28.0,72.0
21.653846153846153,104,35,69,34.0,66.0
28.647058823529413,85,27,58,32.0,68.0
20.181818181818183,88,27,61,31.0,69.0
26.2,65,20,45,31.0,69.0
22.44736842105263,38,13,25,34.0,66.0
24.75,8,3,5,38.0,62.0
121.0,2,2,0,100.0,0.0
87.0,3,2,1,67.0,33.0
13.0,5,2,3,40.0,60.0
14.333333333333334,3,2,1,67.0,33.0
17.727272727272727,11,4,7,36.0,64.0
10.161290322580646,31,16,15,52.0,48.0
13.596153846153847,52,24,28,46.0,54.0
19.406976744186046,86,37,49,43.0,57.0
18.307692307692307,52,21,31,40.0,60.0
17.612903225806452,62,19,43,31.0,69.0
25.42168674698795,83,22,61,27.0,73.0
23.172043010752688,93,25,68,27.0,73.0
40.11827956989247,93,29,64,31.0,69.0
55.717171717171716,99,28,71,28.0,72.0
23.5625,80,30,50,38.0,62.0
20.43548387096774,124,41,83,33.0,67.0
24.541666666666668,144,50,94,35.0,65.0
22.553719008264462,121,33,88,27.0,73.0
24.36842105263158,95,31,64,33.0,67.0
25.35164835164835,91,22,69,24.0,76.0
23.27433628318584,113,29,84,26.0,74.0
24.8,45,16,29,36.0,64.0
15.557692307692308,52,13,39,25.0,75.0
24.08695652173913,23,11,12,48.0,52.0
43.65217391304348,23,11,12,48.0,52.0
23.625,16,3,13,19.0,81.0
11.833333333333334,6,4,2,67.0,33.0
11.6,5,2,3,40.0,60.0
20.5,4,3,1,75.0,25.0
12.545454545454545,11,1,10,9.0,91.0
20.894736842105264,19,11,8,58.0,42.0
22.27777777777778,36,10,26,28.0,72.0
30.20253164556962,79,14,65,18.0,82.0
26.25287356321839,87,18,69,21.0,79.0
28.223214285714285,112,23,89,21.0,79.0
27.475806451612904,124,22,102,18.0,82.0
30.661417322834644,127,33,94,26.0,74.0
25.729508196721312,122,29,93,24.0,76.0
28.5,104,16,88,15.0,85.0
27.93798449612403,129,29,100,22.0,78.0
24.25438596491228,114,32,82,28.0,72.0
24.408,125,23,102,18.0,82.0
31.984848484848484,132,28,104,21.0,79.0
18.64367816091954,87,24,63,28.0,72.0
34.5,88,19,69,22.0,78.0
18.41111111111111,90,17,73,19.0,81.0
33.96153846153846,52,16,36,31.0,69.0
10.695652173913043,23,8,15,35.0,65.0
27.153846153846153,26,6,20,23.0,77.0
33.125,8,1,7,12.0,88.0
44.44444444444444,9,4,5,44.0,56.0
11.75,4,1,3,25.0,75.0
35.2,5,0,5,0.0,100.0
14.333333333333334,6,2,4,33.0,67.0
22.77777777777778,18,7,11,39.0,61.0
14.851851851851851,27,15,12,56.0,44.0
91.28787878787878,66,14,52,21.0,79.0
29.468354430379748,79,20,59,25.0,75.0
19.811965811965813,117,25,92,21.0,79.0
30.132231404958677,121,30,91,25.0,75.0
28.564885496183205,131,19,112,15.0,85.0
25.633587786259543,131,24,107,18.0,82.0
24.007874015748033,127,29,98,23.0,77.0
24.08130081300813,123,27,96,22.0,78.0
29.356521739130436,115,23,92,20.0,80.0
27.516129032258064,93,22,71,24.0,76.0
31.546296296296298,108,26,82,24.0,76.0
20.966666666666665,90,27,63,30.0,70.0
20.806451612903224,62,21,41,34.0,66.0
16.428571428571427,42,5,37,12.0,88.0
36.5625,32,11,21,34.0,66.0
32.0,27,8,19,30.0,70.0
31.375,16,3,13,19.0,81.0
30.25,8,4,4,50.0,50.0
31.4,5,4,1,80.0,20.0
4.5,2,1,1,50.0,50.0
8.789473684210526,19,13,6,68.0,32.0
10.823529411764707,34,20,14,59.0,41.0
14.125,72,40,32,56.0,44.0
11.462264150943396,106,42,64,40.0,60.0
26.186813186813186,91,43,48,47.0,53.0
24.215384615384615,65,21,44,32.0,68.0
28.953488372093023,86,21,65,24.0,76.0
23.921875,128,33,95,26.0,74.0
22.072916666666668,96,22,74,23.0,77.0
19.22826086956522,92,31,61,34.0,66.0
20.9,90,26,64,29.0,71.0
35.482142857142854,112,33,79,29.0,71.0
16.835616438356166,146,52,94,36.0,64.0
25.318181818181817,132,53,79,40.0,60.0
19.357894736842105,95,23,72,24.0,76.0
23.306818181818183,88,29,59,33.0,67.0
45.55789473684211,95,32,63,34.0,66.0
38.134328358208954,67,13,54,19.0,81.0
33.72222222222222,36,6,30,17.0,83.0
12.636363636363637,11,5,6,45.0,55.0
6.0,2,1,1,50.0,50.0
7.5,4,3,1,75.0,25.0
53.75,4,2,2,50.0,50.0
4.666666666666667,6,2,4,33.0,67.0
39.07692307692308,13,5,8,38.0,62.0
18.74418604651163,43,19,24,44.0,56.0
14.043478260869565,69,29,40,42.0,58.0
14.342105263157896,114,46,68,40.0,60.0
17.153846153846153,65,23,42,35.0,65.0
28.098039215686274,51,28,23,55.0,45.0
27.641025641025642,78,28,50,36.0,64.0
14.061946902654867,113,37,76,33.0,67.0
19.823529411764707,102,36,66,35.0,65.0
41.68,100,37,63,37.0,63.0
21.956989247311828,93,34,59,37.0,63.0
22.215384615384615,130,36,94,28.0,72.0
18.564102564102566,156,50,106,32.0,68.0
19.28787878787879,132,52,80,39.0,61.0
18.39669421487603,121,37,84,31.0,69.0
20.737864077669904,103,31,72,30.0,70.0
36.67948717948718,78,28,50,36.0,64.0
21.054545454545455,55,23,32,42.0,58.0
17.304347826086957,23,9,14,39.0,61.0
34.10526315789474,19,5,14,26.0,74.0
19.166666666666668,6,0,6,0.0,100.0
28.75,4,3,1,75.0,25.0
9.25,4,2,2,50.0,50.0
15.75,4,2,2,50.0,50.0
15.666666666666666,12,7,5,58.0,42.0
10.577777777777778,45,15,30,33.0,67.0
12.36986301369863,73,30,43,41.0,59.0
12.14423076923077,104,41,63,39.0,61.0
21.183333333333334,60,16,44,27.0,73.0
19.09375,64,24,40,38.0,62.0
15.31578947368421,76,30,46,39.0,61.0
29.46086956521739,115,39,76,34.0,66.0
26.19607843137255,102,32,70,31.0,69.0
37.57575757575758,99,36,63,36.0,64.0
15.644859813084112,107,46,61,43.0,57.0
20.879432624113477,141,50,91,35.0,65.0
23.778378378378378,185,73,112,39.0,61.0
16.93288590604027,149,40,109,27.0,73.0
21.201612903225808,124,39,85,31.0,69.0
28.128205128205128,117,29,88,25.0,75.0
20.23076923076923,78,21,57,27.0,73.0
27.634615384615383,52,11,41,21.0,79.0
21.857142857142858,35,11,24,31.0,69.0
19.058823529411764,17,6,11,35.0,65.0
34.92857142857143,14,4,10,29.0,71.0
24.666666666666668,3,0,3,0.0,100.0
99.0,5,1,4,20.0,80.0
4.75,4,2,2,50.0,50.0
21.105263157894736,19,7,12,37.0,63.0
11.46875,32,14,18,44.0,56.0
10.533333333333333,60,20,40,33.0,67.0
11.05,120,53,67,44.0,56.0
13.430555555555555,72,33,39,46.0,54.0
24.603174603174605,63,22,41,35.0,65.0
24.083333333333332,84,26,58,31.0,69.0
22.727941176470587,136,49,87,36.0,64.0
37.697916666666664,96,36,60,38.0,62.0
20.445945945945947,74,28,46,38.0,62.0
22.75,116,38,78,33.0,67.0
16.636363636363637,154,55,99,36.0,64.0
21.22012578616352,159,40,119,25.0,75.0
29.967105263157894,152,45,107,30.0,70.0
24.983471074380166,121,31,90,26.0,74.0
28.676923076923078,130,43,87,33.0,67.0
27.954545454545453,66,28,38,42.0,58.0
26.61904761904762,42,10,32,24.0,76.0
14.0,15,14,1,93.0,7.0
20.714285714285715,7,4,3,57.0,43.0
16.285714285714285,7,2,5,29.0,71.0
35.333333333333336,3,3,0,100.0,0.0
54.666666666666664,3,2,1,67.0,33.0
153.0,3,2,1,67.0,33.0
14.692307692307692,13,7,6,54.0,46.0
15.272727272727273,22,12,10,55.0,45.0
10.166666666666666,54,19,35,35.0,65.0
14.403225806451612,62,25,37,40.0,60.0
19.0,72,28,44,39.0,61.0
28.62,50,14,36,28.0,72.0
34.07017543859649,57,21,36,37.0,63.0
21.48611111111111,72,26,46,36.0,64.0
27.105882352941176,85,21,64,25.0,75.0
23.507462686567163,67,24,43,36.0,64.0
23.479166666666668,96,31,65,32.0,68.0
30.26530612244898,98,36,62,37.0,63.0
21.505050505050505,99,41,58,41.0,59.0
22.798076923076923,104,28,76,27.0,73.0
20.03061224489796,98,33,65,34.0,66.0
25.247191011235955,89,26,63,29.0,71.0
28.380281690140844,71,14,57,20.0,80.0
31.87837837837838,74,27,47,36.0,64.0
30.76086956521739,46,10,36,22.0,78.0
22.64,25,6,19,24.0,76.0
13.272727272727273,11,6,5,55.0,45.0
12.222222222222221,9,3,6,33.0,67.0
25.25,8,4,4,50.0,50.0
9.0,3,2,1,67.0,33.0
33.0,2,1,1,50.0,50.0
15.133333333333333,15,7,8,47.0,53.0
34.388888888888886,18,7,11,39.0,61.0
20.5,26,8,18,31.0,69.0
34.475,40,9,31,22.0,78.0
26.246376811594203,69,14,55,20.0,80.0
27.649122807017545,114,27,87,24.0,76.0
35.78703703703704,108,17,91,16.0,84.0
33.02272727272727,88,19,69,22.0,78.0
37.514925373134325,134,23,111,17.0,83.0
31.68686868686869,99,22,77,22.0,78.0
29.01923076923077,104,21,83,20.0,80.0
39.15966386554622,119,20,99,17.0,83.0
32.03488372093023,86,27,59,31.0,69.0
30.028846153846153,104,19,85,18.0,82.0
27.17142857142857,70,16,54,23.0,77.0
30.21794871794872,78,10,68,13.0,87.0
24.145454545454545,55,17,38,31.0,69.0
22.5625,48,9,39,19.0,81.0
38.93103448275862,29,10,19,34.0,66.0
46.03333333333333,30,6,24,20.0,80.0
24.727272727272727,11,5,6,45.0,55.0
27.666666666666668,6,3,3,50.0,50.0
33.5,2,0,2,0.0,100.0
30.0,1,0,1,0.0,100.0
22.214285714285715,14,6,8,43.0,57.0
51.642857142857146,14,9,5,64.0,36.0
50.03846153846154,26,8,18,31.0,69.0
43.660377358490564,53,9,44,17.0,83.0
30.306818181818183,88,21,67,24.0,76.0
27.878048780487806,82,18,64,22.0,78.0
32.6530612244898,98,20,78,20.0,80.0
31.953846153846154,130,25,105,19.0,81.0
29.169934640522875,153,25,128,16.0,84.0
31.842105263157894,152,25,127,16.0,84.0
32.84057971014493,138,38,100,28.0,72.0
28.91216216216216,148,23,125,16.0,84.0
27.854166666666668,144,14,130,10.0,90.0
26.94776119402985,134,35,99,26.0,74.0
28.513274336283185,113,26,87,23.0,77.0
30.65934065934066,91,14,77,15.0,85.0
26.208955223880597,67,11,56,16.0,84.0
26.12962962962963,54,21,33,39.0,61.0
28.941176470588236,17,6,11,35.0,65.0
25.583333333333332,12,5,7,42.0,58.0
21.90909090909091,11,4,7,36.0,64.0
10.333333333333334,3,3,0,100.0,0.0
22.857142857142858,7,6,1,86.0,14.0
13.833333333333334,18,9,9,50.0,50.0
7.090909090909091,22,9,13,41.0,59.0
11.088235294117647,68,29,39,43.0,57.0
14.636363636363637,99,33,66,33.0,67.0
22.26153846153846,65,29,36,45.0,55.0
21.34375,64,19,45,30.0,70.0
27.621951219512194,82,23,59,28.0,72.0
21.904761904761905,84,30,54,36.0,64.0
23.602272727272727,88,23,65,26.0,74.0
22.247619047619047,105,32,73,30.0,70.0
30.036585365853657,82,20,62,24.0,76.0
19.862745098039216,102,35,67,34.0,66.0
21.878048780487806,164,57,107,35.0,65.0
22.411290322580644,124,33,91,27.0,73.0
28.405405405405407,148,44,104,30.0,70.0
30.050847457627118,118,26,92,22.0,78.0
24.386138613861387,101,34,67,34.0,66.0
30.0625,64,16,48,25.0,75.0
20.114285714285714,35,12,23,34.0,66.0
24.346153846153847,26,11,15,42.0,58.0
16.3,10,3,7,30.0,70.0
87.5,6,3,3,50.0,50.0
9.0,3,3,0,100.0,0.0
9.6,5,3,2,60.0,40.0
15.692307692307692,13,5,8,38.0,62.0
39.51724137931034,29,9,20,31.0,69.0
14.444444444444445,72,35,37,49.0,51.0
13.354166666666666,96,35,61,36.0,64.0
14.571428571428571,84,31,53,37.0,63.0
19.737704918032787,61,17,44,28.0,72.0
26.951807228915662,83,26,57,31.0,69.0
24.650943396226417,106,36,70,34.0,66.0
14.24,75,33,42,44.0,56.0
26.666666666666668,75,22,53,29.0,71.0
18.352941176470587,85,29,56,34.0,66.0
17.870689655172413,116,41,75,35.0,65.0
19.625,184,53,131,29.0,71.0
18.901960784313726,153,46,107,30.0,70.0
18.348214285714285,112,33,79,29.0,71.0
36.37179487179487,78,21,57,27.0,73.0
35.067567567567565,74,32,42,43.0,57.0
23.661290322580644,62,10,52,16.0,84.0
31.944444444444443,36,9,27,25.0,75.0
38.0,15,3,12,20.0,80.0
35.5,16,2,14,12.0,88.0
19.88888888888889,9,4,5,44.0,56.0
12.666666666666666,3,0,3,0.0,100.0
11.75,4,2,2,50.0,50.0
7.0,12,8,4,67.0,33.0
20.1875,32,16,16,50.0,50.0
21.952380952380953,63,32,31,51.0,49.0
10.931372549019608,102,46,56,45.0,55.0
21.070422535211268,71,24,47,34.0,66.0
23.642857142857142,56,16,40,29.0,71.0
36.407407407407405,81,25,56,31.0,69.0
24.735294117647058,102,35,67,34.0,66.0
21.041666666666668,72,32,40,44.0,56.0
22.064102564102566,78,25,53,32.0,68.0
27.933333333333334,90,31,59,34.0,66.0
17.212962962962962,108,47,61,44.0,56.0
16.698630136986303,146,42,104,29.0,71.0
18.065217391304348,92,30,62,33.0,67.0
20.068376068376068,117,31,86,26.0,74.0
24.169811320754718,106,26,80,25.0,75.0
22.906666666666666,75,19,56,25.0,75.0
22.625,48,17,31,35.0,65.0
23.4,30,5,25,17.0,83.0
14.9375,16,5,11,31.0,69.0
31.416666666666668,12,7,5,58.0,42.0
25.75,8,2,6,25.0,75.0
34.5,4,0,4,0.0,100.0
8.428571428571429,7,4,3,57.0,43.0
10.4375,16,9,7,56.0,44.0
12.78125,32,16,16,50.0,50.0
13.970149253731343,67,29,38,43.0,57.0
13.650485436893204,103,42,61,41.0,59.0
20.58139534883721,86,31,55,36.0,64.0
23.63235294117647,68,19,49,28.0,72.0
18.476190476190474,84,24,60,29.0,71.0
14.127450980392156,102,39,63,38.0,62.0
29.533333333333335,90,24,66,27.0,73.0
23.93617021276596,94,33,61,35.0,65.0
13.443037974683545,79,25,54,32.0,68.0
26.04,100,33,67,33.0,67.0
15.847222222222221,144,49,95,34.0,66.0
25.517857142857142,112,42,70,38.0,62.0
22.694915254237287,118,42,76,36.0,64.0
20.369565217391305,92,31,61,34.0,66.0
20.57608695652174,92,24,68,26.0,74.0
27.444444444444443,45,9,36,20.0,80.0
16.21276595744681,47,15,32,32.0,68.0
28.333333333333332,24,15,9,62.0,38.0
39.05263157894737,19,5,14,26.0,74.0
20.666666666666668,9,2,7,22.0,78.0
32.5,4,2,2,50.0,50.0
15.6,5,1,4,20.0,80.0
10.615384615384615,13,7,6,54.0,46.0
28.727272727272727,22,7,15,32.0,68.0
16.80327868852459,61,22,39,36.0,64.0
18.345238095238095,84,39,45,46.0,54.0
21.236842105263158,76,21,55,28.0,72.0
26.85185185185185,81,26,55,32.0,68.0
30.684782608695652,92,26,66,28.0,72.0
25.58407079646018,113,35,78,31.0,69.0
20.666666666666668,99,36,63,36.0,64.0
25.092307692307692,130,28,102,22.0,78.0
22.26890756302521,119,42,77,35.0,65.0
25.008849557522122,113,27,86,24.0,76.0
15.735294117647058,136,43,93,32.0,68.0
18.953125,128,44,84,34.0,66.0
23.814814814814813,108,27,81,25.0,75.0
28.673076923076923,104,35,69,34.0,66.0
27.57894736842105,76,31,45,41.0,59.0
20.40625,64,18,46,28.0,72.0
33.19565217391305,46,13,33,28.0,72.0
15.055555555555555,36,11,25,31.0,69.0
24.761904761904763,21,8,13,38.0,62.0
18.428571428571427,14,7,7,50.0,50.0
21.88888888888889,9,1,8,11.0,89.0
12.333333333333334,6,5,1,83.0,17.0
11.75,4,1,3,25.0,75.0
70.3529411764706,17,9,8,53.0,47.0
11.263157894736842,19,7,12,37.0,63.0
24.825,40,13,27,32.0,68.0
25.058823529411764,51,15,36,29.0,71.0
26.662790697674417,86,22,64,26.0,74.0
28.648275862068967,145,28,117,19.0,81.0
22.336363636363636,110,27,83,25.0,75.0
29.472,125,22,103,18.0,82.0
29.57547169811321,106,25,81,24.0,76.0
27.744827586206895,145,37,108,26.0,74.0
21.823529411764707,153,29,124,19.0,81.0
24.19083969465649,131,18,113,14.0,86.0
30.035211267605632,142,23,119,16.0,84.0
61.1530612244898,98,26,72,27.0,73.0
16.0,2,0,2,0.0,100.0
26.75,44,17,27,39.0,61.0
20.916666666666668,36,14,22,39.0,61.0
25.90909090909091,44,13,31,30.0,70.0
24.272727272727273,22,5,17,23.0,77.0
19.5,4,2,2,50.0,50.0
10.75,4,1,3,25.0,75.0
56.25,8,5,3,62.0,38.0
49.285714285714285,14,4,10,29.0,71.0
95.62068965517241,29,12,17,41.0,59.0
57.34285714285714,35,8,27,23.0,77.0
30.333333333333332,39,13,26,33.0,67.0
38.59756097560975,82,17,65,21.0,79.0
39.88181818181818,110,28,82,25.0,75.0
28.36111111111111,108,24,84,22.0,78.0
28.39622641509434,106,20,86,19.0,81.0
24.652542372881356,118,23,95,19.0,81.0
28.023668639053255,169,35,134,21.0,79.0
38.376068376068375,117,28,89,24.0,76.0
25.598591549295776,142,26,116,18.0,82.0
24.272,125,25,100,20.0,80.0
28.91578947368421,95,20,75,21.0,79.0
25.901408450704224,71,18,53,25.0,75.0
23.77777777777778,81,25,56,31.0,69.0
17.15625,32,9,23,28.0,72.0
18.864864864864863,37,13,24,35.0,65.0
10.846153846153847,13,4,9,31.0,69.0
47.1,10,2,8,20.0,80.0
10.666666666666666,6,1,5,17.0,83.0
6.0,1,0,1,0.0,100.0
15.666666666666666,3,3,0,100.0,0.0
19.0,9,2,7,22.0,78.0
10.043478260869565,23,11,12,48.0,52.0
11.450980392156863,51,20,31,39.0,61.0
12.082191780821917,73,31,42,42.0,58.0
20.942307692307693,52,20,32,38.0,62.0
23.452380952380953,42,6,36,14.0,86.0
27.508474576271187,59,20,39,34.0,66.0
20.451219512195124,82,26,56,32.0,68.0
33.74285714285714,70,23,47,33.0,67.0
39.97560975609756,82,22,60,27.0,73.0
20.119402985074625,67,20,47,30.0,70.0
21.294642857142858,112,30,82,27.0,73.0
17.96923076923077,130,50,80,38.0,62.0
30.95049504950495,101,40,61,40.0,60.0
18.88157894736842,76,30,46,39.0,61.0
21.71951219512195,82,21,61,26.0,74.0
28.695652173913043,69,13,56,19.0,81.0
23.30909090909091,55,17,38,31.0,69.0
43.017857142857146,56,16,40,29.0,71.0
37.65,20,4,16,20.0,80.0
32.73684210526316,19,4,15,21.0,79.0
13.2,5,0,5,0.0,100.0
6.833333333333333,6,4,2,67.0,33.0
10.692307692307692,13,3,10,23.0,77.0
22.72,25,13,12,52.0,48.0
10.627118644067796,59,23,36,39.0,61.0
12.0,62,26,36,42.0,58.0
15.625,56,21,35,38.0,62.0
20.333333333333332,42,12,30,29.0,71.0
20.36231884057971,69,15,54,22.0,78.0
26.50588235294118,85,25,60,29.0,71.0
20.831460674157302,89,21,68,24.0,76.0
17.985294117647058,68,27,41,40.0,60.0
22.986486486486488,74,23,51,31.0,69.0
28.232323232323232,99,34,65,34.0,66.0
14.278571428571428,140,43,97,31.0,69.0
17.853846153846153,130,48,82,37.0,63.0
24.597701149425287,87,27,60,31.0,69.0
22.2,80,28,52,35.0,65.0
18.35593220338983,59,16,43,27.0,73.0
29.404255319148938,47,19,28,40.0,60.0
22.818181818181817,33,13,20,39.0,61.0
17.823529411764707,17,8,9,47.0,53.0
18.727272727272727,11,5,6,45.0,55.0
246.5,8,6,2,75.0,25.0
19.444444444444443,9,3,6,33.0,67.0
17.0,4,2,2,50.0,50.0
12.583333333333334,12,3,9,25.0,75.0
30.263157894736842,19,10,9,53.0,47.0
12.452380952380953,42,20,22,48.0,52.0
14.511904761904763,84,37,47,44.0,56.0
18.479166666666668,48,20,28,42.0,58.0
25.379310344827587,58,22,36,38.0,62.0
32.48913043478261,92,36,56,39.0,61.0
19.097826086956523,92,30,62,33.0,67.0
27.348837209302324,86,29,57,34.0,66.0
21.41269841269841,63,26,37,41.0,59.0
20.89873417721519,79,27,52,34.0,66.0
16.027272727272727,110,45,65,41.0,59.0
21.766129032258064,124,46,78,37.0,63.0
19.476635514018692,107,40,67,37.0,63.0
18.673267326732674,101,32,69,32.0,68.0
21.382716049382715,81,28,53,35.0,65.0
27.76086956521739,92,23,69,25.0,75.0
22.591836734693878,49,13,36,27.0,73.0
21.53488372093023,43,15,28,35.0,65.0
26.75,20,5,15,25.0,75.0
15.909090909090908,11,2,9,18.0,82.0
15.166666666666666,6,3,3,50.0,50.0
9.0,3,1,2,33.0,67.0
29.0,3,2,1,67.0,33.0
9.714285714285714,14,3,11,21.0,79.0
13.92,25,12,13,48.0,52.0
9.58,50,22,28,44.0,56.0
14.766233766233766,77,36,41,47.0,53.0
16.236363636363638,55,30,25,55.0,45.0
19.50877192982456,57,20,37,35.0,65.0
17.11904761904762,84,21,63,25.0,75.0
19.064814814814813,108,38,70,35.0,65.0
24.8659793814433,97,29,68,30.0,70.0
24.11111111111111,72,27,45,38.0,62.0
21.792079207920793,101,26,75,26.0,74.0
20.182795698924732,93,35,58,38.0,62.0
19.579268292682926,164,61,103,37.0,63.0
23.265151515151516,132,42,90,32.0,68.0
30.312,125,42,83,34.0,66.0
20.146067415730336,89,18,71,20.0,80.0
23.428571428571427,70,23,47,33.0,67.0
27.25,56,21,35,38.0,62.0
12.8,30,12,18,40.0,60.0
101.29629629629629,27,8,19,30.0,70.0
37.0,9,7,2,78.0,22.0
29.4,5,3,2,60.0,40.0
26.166666666666668,6,1,5,17.0,83.0
7.5,4,0,4,0.0,100.0
11.8,10,6,4,60.0,40.0
19.136363636363637,22,11,11,50.0,50.0
13.326086956521738,46,17,29,37.0,63.0
12.648936170212766,94,43,51,46.0,54.0
17.42622950819672,61,25,36,41.0,59.0
22.533333333333335,60,23,37,38.0,62.0
19.649350649350648,77,21,56,27.0,73.0
28.06382978723404,94,20,74,21.0,79.0
24.74561403508772,114,46,68,40.0,60.0
25.19298245614035,114,32,82,28.0,72.0
26.46808510638298,94,24,70,26.0,74.0
21.992248062015506,129,37,92,29.0,71.0
23.33103448275862,145,29,116,20.0,80.0
21.238532110091743,109,31,78,28.0,72.0
23.080291970802918,137,31,106,23.0,77.0
22.41304347826087,92,30,62,33.0,67.0
28.85148514851485,101,27,74,27.0,73.0
25.571428571428573,70,11,59,16.0,84.0
29.17391304347826,69,11,58,16.0,84.0
16.5,36,8,28,22.0,78.0
22.321428571428573,28,9,19,32.0,68.0
14.619047619047619,21,4,17,19.0,81.0
17.0,3,1,2,33.0,67.0
10.0,1,0,1,0.0,100.0
33.0,2,1,1,50.0,50.0
12.0,9,2,7,22.0,78.0
34.31818181818182,22,14,8,64.0,36.0
22.51851851851852,27,10,17,37.0,63.0
26.933333333333334,60,15,45,25.0,75.0
31.87142857142857,70,15,55,21.0,79.0
39.340425531914896,94,20,74,21.0,79.0
30.27972027972028,143,26,117,18.0,82.0
36.08029197080292,137,25,112,18.0,82.0
30.25,132,26,106,20.0,80.0
25.6015625,128,20,108,16.0,84.0
24.057553956834532,139,36,103,26.0,74.0
21.74025974025974,154,37,117,24.0,76.0
25.711409395973153,149,34,115,23.0,77.0
41.766666666666666,150,20,130,13.0,87.0
24.214285714285715,140,21,119,15.0,85.0
23.925925925925927,108,18,90,17.0,83.0
31.272727272727273,110,25,85,23.0,77.0
27.673684210526314,95,20,75,21.0,79.0
21.3,40,9,31,22.0,78.0
37.61904761904762,21,3,18,14.0,86.0
21.76923076923077,13,3,10,23.0,77.0
41.0,5,2,3,40.0,60.0
10.666666666666666,3,2,1,67.0,33.0
9.4,5,2,3,40.0,60.0
8.88888888888889,9,1,8,11.0,89.0
15.384615384615385,13,5,8,38.0,62.0
8.275862068965518,29,16,13,55.0,45.0
41.73684210526316,57,14,43,25.0,75.0
33.09230769230769,65,18,47,28.0,72.0
32.27272727272727,88,14,74,16.0,84.0
39.94,100,21,79,21.0,79.0
37.13392857142857,112,14,98,12.0,88.0
24.964912280701753,114,19,95,17.0,83.0
25.181159420289855,138,35,103,25.0,75.0
30.02542372881356,118,19,99,16.0,84.0
22.140350877192983,114,23,91,20.0,80.0
32.294117647058826,119,27,92,23.0,77.0
24.766990291262136,103,16,87,16.0,84.0
22.78205128205128,78,22,56,28.0,72.0
16.045454545454547,44,18,26,41.0,59.0
29.894736842105264,57,12,45,21.0,79.0
27.885714285714286,35,6,29,17.0,83.0
24.866666666666667,15,2,13,13.0,87.0
41.5,12,3,9,25.0,75.0
77.5,2,2,0,100.0,0.0
40.8,5,1,4,20.0,80.0
13.25,4,4,0,100.0,0.0
25.77777777777778,9,6,3,67.0,33.0
10.583333333333334,36,14,22,39.0,61.0
13.46,50,24,26,48.0,52.0
11.71951219512195,82,40,42,49.0,51.0
16.609375,64,31,33,48.0,52.0
23.90909090909091,44,12,32,27.0,73.0
18.95,60,20,40,33.0,67.0
14.966101694915254,59,17,42,29.0,71.0
25.592105263157894,76,21,55,28.0,72.0
24.253968253968253,63,21,42,33.0,67.0
17.414634146341463,82,28,54,34.0,66.0
25.92982456140351,114,51,63,45.0,55.0
18.642276422764226,123,43,80,35.0,65.0
24.323809523809523,105,35,70,33.0,67.0
16.726027397260275,73,24,49,33.0,67.0
18.901408450704224,71,22,49,31.0,69.0
36.810344827586206,58,13,45,22.0,78.0
26.025641025641026,39,12,27,31.0,69.0
27.18421052631579,38,7,31,18.0,82.0
104.2,15,6,9,40.0,60.0
14.571428571428571,7,3,4,43.0,57.0
12.666666666666666,6,2,4,33.0,67.0
36.0,2,1,1,50.0,50.0
11.0,2,2,0,100.0,0.0
11.0,7,3,4,43.0,57.0
12.666666666666666,24,10,14,42.0,58.0
24.06779661016949,59,21,38,36.0,64.0
12.640449438202246,89,43,46,48.0,52.0
13.017857142857142,56,25,31,45.0,55.0
24.775510204081634,49,23,26,47.0,53.0
22.02777777777778,72,21,51,29.0,71.0
16.25609756097561,82,22,60,27.0,73.0
22.28395061728395,81,29,52,36.0,64.0
18.714285714285715,63,27,36,43.0,57.0
28.25,84,26,58,31.0,69.0
23.240506329113924,79,25,54,32.0,68.0
14.7109375,128,48,80,38.0,62.0
17.754901960784313,102,29,73,28.0,72.0
26.26732673267327,101,35,66,35.0,65.0
43.86206896551724,58,22,36,38.0,62.0
17.67391304347826,46,18,28,39.0,61.0
41.53488372093023,43,11,32,26.0,74.0
14.1875,32,13,19,41.0,59.0
73.0,13,4,9,31.0,69.0
21.6,5,1,4,20.0,80.0
27.545454545454547,11,6,5,55.0,45.0
9.333333333333334,3,3,0,100.0,0.0
9.0,4,2,2,50.0,50.0
35.0,8,4,4,50.0,50.0
8.107142857142858,28,15,13,54.0,46.0
11.22,50,22,28,44.0,56.0
18.598130841121495,107,43,64,40.0,60.0
15.392156862745098,51,18,33,35.0,65.0
17.4375,48,19,29,40.0,60.0
17.32857142857143,70,31,39,44.0,56.0
14.585714285714285,70,28,42,40.0,60.0
14.808988764044944,89,29,60,33.0,67.0
17.14864864864865,74,30,44,41.0,59.0
20.3125,80,29,51,36.0,64.0
14.857142857142858,84,34,50,40.0,60.0
16.04310344827586,116,48,68,41.0,59.0
25.16521739130435,115,35,80,30.0,70.0
18.223684210526315,76,28,48,37.0,63.0
25.26530612244898,49,17,32,35.0,65.0
18.206349206349206,63,20,43,32.0,68.0
24.31578947368421,38,15,23,39.0,61.0
29.03125,32,7,25,22.0,78.0
9.8,15,1,14,7.0,93.0
14.2,5,1,4,20.0,80.0
40.0,1,1,0,100.0,0.0
16.0,2,2,0,100.0,0.0
8.0,3,2,1,67.0,33.0
12.333333333333334,12,6,6,50.0,50.0
22.444444444444443,18,11,7,61.0,39.0
9.772727272727273,44,23,21,52.0,48.0
10.878048780487806,82,33,49,40.0,60.0
26.825396825396826,63,33,30,52.0,48.0
18.178571428571427,56,26,30,46.0,54.0
14.208333333333334,48,18,30,38.0,62.0
16.592105263157894,76,32,44,42.0,58.0
21.2,65,28,37,43.0,57.0
44.63793103448276,58,28,30,48.0,52.0
12.855072463768115,69,25,44,36.0,64.0
18.776699029126213,103,31,72,30.0,70.0
22.507462686567163,134,52,82,39.0,61.0
18.565217391304348,115,38,77,33.0,67.0
36.175824175824175,91,33,58,36.0,64.0
17.016949152542374,59,22,37,37.0,63.0
20.653846153846153,52,19,33,37.0,63.0
17.928571428571427,42,16,26,38.0,62.0
12.933333333333334,30,9,21,30.0,70.0
46.77272727272727,22,11,11,50.0,50.0
14.142857142857142,7,4,3,57.0,43.0
12.142857142857142,7,3,4,43.0,57.0
14.0,1,0,1,0.0,100.0
10.2,5,2,3,40.0,60.0
66.0,12,7,5,58.0,42.0
14.272727272727273,22,12,10,55.0,45.0
12.978260869565217,46,28,18,61.0,39.0
17.397435897435898,78,31,47,40.0,60.0
11.814814814814815,54,27,27,50.0,50.0
22.563636363636363,55,17,38,31.0,69.0
23.509090909090908,55,19,36,35.0,65.0
18.833333333333332,78,29,49,37.0,63.0
30.396039603960396,101,35,66,35.0,65.0
17.604166666666668,96,35,61,36.0,64.0
18.765217391304347,115,31,84,27.0,73.0
17.583333333333332,108,22,86,20.0,80.0
17.612903225806452,124,41,83,33.0,67.0
18.153846153846153,104,31,73,30.0,70.0
23.886363636363637,88,26,62,30.0,70.0
17.512820512820515,78,22,56,28.0,72.0
28.38157894736842,76,16,60,21.0,79.0
31.20967741935484,62,13,49,21.0,79.0
18.272727272727273,22,5,17,23.0,77.0
17.571428571428573,28,9,19,32.0,68.0
15.1,20,7,13,35.0,65.0
16.0,6,2,4,33.0,67.0
19.0,9,2,7,22.0,78.0
39.0,2,0,2,0.0,100.0
7.666666666666667,3,2,1,67.0,33.0
39.666666666666664,6,4,2,67.0,33.0
10.11111111111111,9,7,2,78.0,22.0
13.030303030303031,33,15,18,45.0,55.0
17.5,48,20,28,42.0,58.0
21.015384615384615,65,14,51,22.0,78.0
26.093333333333334,75,20,55,27.0,73.0
31.056603773584907,106,17,89,16.0,84.0
29.345864661654137,133,33,100,25.0,75.0
38.95762711864407,118,15,103,13.0,87.0
29.47008547008547,117,24,93,21.0,79.0
25.142857142857142,112,20,92,18.0,82.0
23.570247933884296,121,22,99,18.0,82.0
32.05882352941177,119,22,97,18.0,82.0
18.846153846153847,91,22,69,24.0,76.0
21.17,100,20,80,20.0,80.0
17.596491228070175,57,16,41,28.0,72.0
14.714285714285714,49,15,34,31.0,69.0
14.24,50,19,31,38.0,62.0
20.956521739130434,23,9,14,39.0,61.0
24.458333333333332,24,6,18,25.0,75.0
7.5625,16,6,10,38.0,62.0
2.5,2,2,0,100.0,0.0
9.0,1,0,1,0.0,100.0
4.833333333333333,6,4,2,67.0,33.0
30.666666666666668,3,1,2,33.0,67.0
15.0,13,8,5,62.0,38.0
11.0,20,11,9,55.0,45.0
23.045454545454547,44,12,32,27.0,73.0
31.822580645161292,62,25,37,40.0,60.0
24.58695652173913,92,31,61,34.0,66.0
29.223214285714285,112,25,87,22.0,78.0
31.31645569620253,79,14,65,18.0,82.0
24.0,84,27,57,32.0,68.0
24.48076923076923,104,21,83,20.0,80.0
18.872340425531913,94,37,57,39.0,61.0
22.666666666666668,75,24,51,32.0,68.0
17.72151898734177,79,29,50,37.0,63.0
38.142857142857146,42,22,20,52.0,48.0
19.772151898734176,79,29,50,37.0,63.0
18.875,40,14,26,35.0,65.0
21.657894736842106,38,13,25,34.0,66.0
24.4,20,8,12,40.0,60.0
20.63157894736842,19,5,14,26.0,74.0
19.0,5,2,3,40.0,60.0
5.0,1,0,1,0.0,100.0
13.333333333333334,3,2,1,67.0,33.0
8.058823529411764,17,12,5,71.0,29.0
40.86666666666667,15,8,7,53.0,47.0
13.777777777777779,45,22,23,49.0,51.0
11.457831325301205,83,32,51,39.0,61.0
17.77777777777778,54,19,35,35.0,65.0
24.584615384615386,65,16,49,25.0,75.0
24.951612903225808,62,27,35,44.0,56.0
18.94736842105263,57,28,29,49.0,51.0
36.07142857142857,84,33,51,39.0,61.0
19.885245901639344,61,27,34,44.0,56.0
23.43421052631579,76,32,44,42.0,58.0
16.462264150943398,106,49,57,46.0,54.0
21.583333333333332,132,58,74,44.0,56.0
15.326530612244898,98,32,66,33.0,67.0
23.38372093023256,86,31,55,36.0,64.0
24.70175438596491,57,22,35,39.0,61.0
67.66666666666667,54,15,39,28.0,72.0
12.037037037037036,27,7,20,26.0,74.0
23.12,25,6,19,24.0,76.0
36.8421052631579,19,7,12,37.0,63.0
36.25,4,1,3,25.0,75.0
15.0,4,2,2,50.0,50.0
5.0,1,1,0,100.0,0.0
8.428571428571429,7,3,4,43.0,57.0
8.923076923076923,13,8,5,62.0,38.0
34.758620689655174,29,11,18,38.0,62.0
14.169230769230769,65,34,31,52.0,48.0
11.960526315789474,76,32,44,42.0,58.0
19.485294117647058,68,28,40,41.0,59.0
18.18421052631579,76,25,51,33.0,67.0
60.80246913580247,81,32,49,40.0,60.0
26.30263157894737,76,26,50,34.0,66.0
16.318181818181817,66,25,41,38.0,62.0
18.40963855421687,83,34,49,41.0,59.0
19.742857142857144,70,27,43,39.0,61.0
15.923809523809524,105,49,56,47.0,53.0
15.153225806451612,124,48,76,39.0,61.0
21.18103448275862,116,39,77,34.0,66.0
21.185185185185187,81,19,62,23.0,77.0
19.07547169811321,53,22,31,42.0,58.0
27.524590163934427,61,12,49,20.0,80.0
30.608695652173914,46,17,29,37.0,63.0
7.375,16,11,5,69.0,31.0
15.4,10,3,7,30.0,70.0
6.75,8,2,6,25.0,75.0
28.0,1,0,1,0.0,100.0
8.333333333333334,3,2,1,67.0,33.0
10.0,13,6,7,46.0,54.0
49.142857142857146,28,9,19,32.0,68.0
10.372093023255815,43,16,27,37.0,63.0
10.421686746987952,83,39,44,47.0,53.0
12.595744680851064,47,27,20,57.0,43.0
18.214285714285715,42,18,24,43.0,57.0
14.338028169014084,71,39,32,55.0,45.0
17.967741935483872,62,24,38,39.0,61.0
21.914285714285715,70,28,42,40.0,60.0
14.152542372881356,59,29,30,49.0,51.0
26.171717171717173,99,43,56,43.0,57.0
16.061855670103093,97,44,53,45.0,55.0
13.156716417910447,134,52,82,39.0,61.0
15.661016949152541,118,51,67,43.0,57.0
26.305263157894736,95,38,57,40.0,60.0
32.11290322580645,62,30,32,48.0,52.0
21.816901408450704,71,24,47,34.0,66.0
17.02857142857143,35,9,26,26.0,74.0
17.48148148148148,27,17,10,63.0,37.0
32.833333333333336,12,2,10,17.0,83.0
10.9,10,2,8,20.0,80.0
66.66666666666667,6,2,4,33.0,67.0
21.0,2,1,1,50.0,50.0
22.0,4,2,2,50.0,50.0
5.888888888888889,18,12,6,67.0,33.0
11.4375,16,6,10,38.0,62.0
20.482758620689655,58,29,29,50.0,50.0
11.207317073170731,82,37,45,45.0,55.0
15.411764705882353,68,30,38,44.0,56.0
32.285714285714285,42,13,29,31.0,69.0
19.059701492537314,67,32,35,48.0,52.0
42.04615384615385,65,30,35,46.0,54.0
16.3,80,42,38,52.0,48.0
51.22077922077922,77,29,48,38.0,62.0
19.746478873239436,71,32,39,45.0,55.0
20.54639175257732,97,33,64,34.0,66.0
21.340425531914892,141,49,92,35.0,65.0
18.285714285714285,98,33,65,34.0,66.0
22.473118279569892,93,35,58,38.0,62.0
37.37096774193548,62,19,43,31.0,69.0
30.634615384615383,52,14,38,27.0,73.0
23.425925925925927,54,22,32,41.0,59.0
13.695652173913043,23,9,14,39.0,61.0
19.6,20,7,13,35.0,65.0
18.0,5,3,2,60.0,40.0
11.5,2,1,1,50.0,50.0
4.5,2,1,1,50.0,50.0
78.33333333333333,6,3,3,50.0,50.0
16.0,10,3,7,30.0,70.0
13.291666666666666,24,15,9,62.0,38.0
17.928571428571427,56,30,26,54.0,46.0
13.855072463768115,69,30,39,43.0,57.0
18.235294117647058,51,24,27,47.0,53.0
21.224489795918366,49,23,26,47.0,53.0
24.612903225806452,62,21,41,34.0,66.0
22.90909090909091,88,36,52,41.0,59.0
28.70731707317073,82,23,59,28.0,72.0
25.972477064220183,109,35,74,32.0,68.0
25.904761904761905,105,35,70,33.0,67.0
24.21186440677966,118,42,76,36.0,64.0
21.424836601307188,153,51,102,33.0,67.0
30.694915254237287,118,32,86,27.0,73.0
16.0,75,27,48,36.0,64.0
40.513888888888886,72,21,51,29.0,71.0
19.88888888888889,63,22,41,35.0,65.0
32.18032786885246,61,9,52,15.0,85.0
17.76,25,6,19,24.0,76.0
95.16666666666667,18,3,15,17.0,83.0
35.45454545454545,22,2,20,9.0,91.0
42.3,10,2,8,20.0,80.0
12.666666666666666,3,1,2,33.0,67.0
21.666666666666668,3,1,2,33.0,67.0
4.833333333333333,6,4,2,67.0,33.0
12.0,5,2,3,40.0,60.0
100.2,20,11,9,55.0,45.0
15.272727272727273,33,16,17,48.0,52.0
33.0,52,14,38,27.0,73.0
23.775,80,22,58,28.0,72.0
25.580952380952382,105,26,79,25.0,75.0
24.663716814159294,113,20,93,18.0,82.0
26.27358490566038,106,26,80,25.0,75.0
29.5,118,16,102,14.0,86.0
32.794871794871796,117,28,89,24.0,76.0
27.910344827586208,145,37,108,26.0,74.0
30.876033057851238,121,24,97,20.0,80.0
24.482758620689655,116,26,90,22.0,78.0
25.487603305785125,121,20,101,17.0,83.0
28.810344827586206,116,45,71,39.0,61.0
18.135135135135137,74,22,52,30.0,70.0
21.96969696969697,33,10,23,30.0,70.0
31.08823529411765,34,9,25,26.0,74.0
25.06451612903226,31,8,23,26.0,74.0
8.833333333333334,12,2,10,17.0,83.0
12.636363636363637,11,6,5,55.0,45.0
13.2,5,2,3,40.0,60.0
28.142857142857142,7,0,7,0.0,100.0
6.5,2,0,2,0.0,100.0
15.142857142857142,7,4,3,57.0,43.0
17.1875,16,7,9,44.0,56.0
14.392857142857142,28,6,22,21.0,79.0
17.896551724137932,58,16,42,28.0,72.0
25.73015873015873,63,8,55,13.0,87.0
40.72043010752688,93,20,73,22.0,78.0
26.65573770491803,122,27,95,22.0,78.0
33.376,125,24,101,19.0,81.0
38.97222222222222,144,25,119,17.0,83.0
28.053435114503817,131,26,105,20.0,80.0
27.625,128,23,105,18.0,82.0
32.371428571428574,140,29,111,21.0,79.0
25.05,120,31,89,26.0,74.0
33.231404958677686,121,29,92,24.0,76.0
28.551724137931036,87,12,75,14.0,86.0
31.946428571428573,56,8,48,14.0,86.0
32.90163934426229,61,11,50,18.0,82.0
55.54545454545455,44,10,34,23.0,77.0
23.73076923076923,26,7,19,27.0,73.0
23.263157894736842,19,5,14,26.0,74.0
35.388888888888886,18,5,13,28.0,72.0
11.5,2,1,1,50.0,50.0
12.5,2,1,1,50.0,50.0
10.1,10,5,5,50.0,50.0
10.090909090909092,11,4,7,36.0,64.0
21.032258064516128,31,14,17,45.0,55.0
20.533333333333335,45,22,23,49.0,51.0
19.903846153846153,52,19,33,37.0,63.0
26.295774647887324,71,14,57,20.0,80.0
34.734939759036145,83,10,73,12.0,88.0
31.263636363636362,110,19,91,17.0,83.0
32.38317757009346,107,26,81,24.0,76.0
30.797101449275363,138,35,103,25.0,75.0
27.5546875,128,26,102,20.0,80.0
25.365079365079364,126,22,104,17.0,83.0
23.295652173913044,115,36,79,31.0,69.0
19.850574712643677,87,26,61,30.0,70.0
20.318181818181817,66,23,43,35.0,65.0
21.142857142857142,28,12,16,43.0,57.0
18.866666666666667,30,6,24,20.0,80.0
19.80952380952381,21,4,17,19.0,81.0
20.8,15,3,12,20.0,80.0
22.5,2,0,2,0.0,100.0
9.0,1,0,1,0.0,100.0
13.833333333333334,6,3,3,50.0,50.0
8.0,7,3,4,43.0,57.0
9.5,20,7,13,35.0,65.0
12.285714285714286,49,26,23,53.0,47.0
10.419753086419753,81,40,41,49.0,51.0
21.822222222222223,45,20,25,44.0,56.0
121.75,4,2,2,50.0,50.0
24.369565217391305,46,19,27,41.0,59.0
38.09278350515464,97,32,65,33.0,67.0
24.010204081632654,98,33,65,34.0,66.0
20.346153846153847,104,39,65,38.0,62.0
18.9,100,40,60,40.0,60.0
46.084210526315786,95,32,63,34.0,66.0
19.511904761904763,84,28,56,33.0,67.0
19.25581395348837,43,13,30,30.0,70.0
27.543478260869566,46,13,33,28.0,72.0
22.321428571428573,28,5,23,18.0,82.0
21.76923076923077,13,3,10,23.0,77.0
37.0,3,0,3,0.0,100.0
8.714285714285714,7,6,1,86.0,14.0
159.5,2,2,0,100.0,0.0
11.333333333333334,6,4,2,67.0,33.0
7.9375,16,6,10,38.0,62.0
8.434782608695652,23,7,16,30.0,70.0
12.120689655172415,58,26,32,45.0,55.0
15.617977528089888,89,38,51,43.0,57.0
14.606060606060606,66,31,35,47.0,53.0
27.35483870967742,31,13,18,42.0,58.0
17.239436619718308,71,29,42,41.0,59.0
20.03125,64,18,46,28.0,72.0
19.0,73,29,44,40.0,60.0
21.486486486486488,74,23,51,31.0,69.0
24.0,71,29,42,41.0,59.0
21.322033898305083,118,39,79,33.0,67.0
16.494444444444444,180,53,127,29.0,71.0
18.043478260869566,161,40,121,25.0,75.0
19.38,100,31,69,31.0,69.0
18.218309859154928,142,27,115,19.0,81.0
19.5,60,14,46,23.0,77.0
21.01492537313433,67,17,50,25.0,75.0
62.77777777777778,27,3,24,11.0,89.0
14.0,8,5,3,62.0,38.0
18.357142857142858,14,10,4,71.0,29.0
7.666666666666667,6,2,4,33.0,67.0
15.0,1,1,0,100.0,0.0
5.6,5,2,3,40.0,60.0
9.823529411764707,17,3,14,18.0,82.0
11.25,28,9,19,32.0,68.0
11.523076923076923,65,25,40,38.0,62.0
17.333333333333332,96,29,67,30.0,70.0
19.75,56,24,32,43.0,57.0
20.03846153846154,52,18,34,35.0,65.0
19.869565217391305,69,19,50,28.0,72.0
20.97345132743363,113,26,87,23.0,77.0
40.535714285714285,84,19,65,23.0,77.0
23.77922077922078,77,23,54,30.0,70.0
20.91346153846154,104,27,77,26.0,74.0
16.195876288659793,97,36,61,37.0,63.0
15.062146892655367,177,54,123,31.0,69.0
16.614525139664803,179,36,143,20.0,80.0
16.878504672897197,107,25,82,23.0,77.0
15.527777777777779,72,21,51,29.0,71.0
23.301369863013697,73,14,59,19.0,81.0
20.42622950819672,61,19,42,31.0,69.0
11.647058823529411,34,12,22,35.0,65.0
14.9375,16,6,10,38.0,62.0
21.428571428571427,7,1,6,14.0,86.0
4.0,1,1,0,100.0,0.0
6.5,2,1,1,50.0,50.0
6.25,8,6,2,75.0,25.0
9.909090909090908,11,3,8,27.0,73.0
6.434782608695652,23,6,17,26.0,74.0
15.0,65,29,36,45.0,55.0
19.514851485148515,101,31,70,31.0,69.0
21.225352112676056,71,22,49,31.0,69.0
16.974025974025974,77,25,52,32.0,68.0
24.07920792079208,101,17,84,17.0,83.0
22.709923664122137,131,27,104,21.0,79.0
36.89928057553957,139,18,121,13.0,87.0
23.779661016949152,118,29,89,25.0,75.0
21.07079646017699,113,21,92,19.0,81.0
18.146853146853147,143,31,112,22.0,78.0
18.018072289156628,166,52,114,31.0,69.0
19.57843137254902,102,31,71,30.0,70.0
22.551020408163264,98,30,68,31.0,69.0
21.573529411764707,68,22,46,32.0,68.0
19.20689655172414,58,17,41,29.0,71.0
24.15909090909091,44,14,30,32.0,68.0
17.71212121212121,66,8,58,12.0,88.0
15.236842105263158,38,8,30,21.0,79.0
37.5,22,3,19,14.0,86.0
17.875,8,2,6,25.0,75.0
13.25,16,2,14,12.0,88.0
8.25,4,1,3,25.0,75.0
7.75,4,3,1,75.0,25.0
7.285714285714286,7,2,5,29.0,71.0
11.35,20,7,13,35.0,65.0
29.90625,32,9,23,28.0,72.0
18.42105263157895,76,16,60,21.0,79.0
22.615384615384617,91,21,70,23.0,77.0
22.607142857142858,56,11,45,20.0,80.0
25.38317757009346,107,15,92,14.0,86.0
25.971698113207548,106,26,80,25.0,75.0
27.435897435897434,117,33,84,28.0,72.0
23.745283018867923,106,26,80,25.0,75.0
24.52892561983471,121,24,97,20.0,80.0
22.07563025210084,119,32,87,27.0,73.0
24.279661016949152,118,26,92,22.0,78.0
18.95798319327731,119,27,92,23.0,77.0
23.833333333333332,96,25,71,26.0,74.0
19.135135135135137,74,14,60,19.0,81.0
20.934426229508198,61,19,42,31.0,69.0
11.76,50,8,42,16.0,84.0
17.925,40,4,36,10.0,90.0
24.526315789473685,19,6,13,32.0,68.0
10.166666666666666,12,6,6,50.0,50.0
20.2,5,3,2,60.0,40.0
34.0,4,2,2,50.0,50.0
16.25,4,0,4,0.0,100.0
14.8,10,4,6,40.0,60.0
17.5,6,3,3,50.0,50.0
18.92105263157895,38,14,24,37.0,63.0
19.773333333333333,75,19,56,25.0,75.0
25.183908045977013,87,12,75,14.0,86.0
27.093023255813954,86,19,67,22.0,78.0
21.80392156862745,102,25,77,25.0,75.0
27.858407079646017,113,18,95,16.0,84.0
26.624,125,26,99,21.0,79.0
26.326923076923077,104,19,85,18.0,82.0
28.62037037037037,108,38,70,35.0,65.0
27.37313432835821,134,29,105,22.0,78.0
22.853211009174313,109,24,85,22.0,78.0
23.784313725490197,102,32,70,31.0,69.0
28.7,50,17,33,34.0,66.0
24.208955223880597,67,16,51,24.0,76.0
19.70967741935484,31,8,23,26.0,74.0
37.73076923076923,26,12,14,46.0,54.0
15.3,10,1,9,10.0,90.0
50.666666666666664,6,1,5,17.0,83.0
39.0,1,1,0,100.0,0.0
10.5,2,1,1,50.0,50.0
9.0,2,2,0,100.0,0.0
7.571428571428571,7,5,2,71.0,29.0
13.631578947368421,19,8,11,42.0,58.0
11.487179487179487,39,13,26,33.0,67.0
14.537313432835822,67,26,41,39.0,61.0
22.2,40,20,20,50.0,50.0
17.510204081632654,49,15,34,31.0,69.0
16.384615384615383,52,15,37,29.0,71.0
20.776119402985074,67,14,53,21.0,79.0
26.083333333333332,84,20,64,24.0,76.0
19.193548387096776,62,22,40,35.0,65.0
14.408163265306122,49,23,26,47.0,53.0
20.0,76,41,35,54.0,46.0
14.961904761904762,105,47,58,45.0,55.0
15.24390243902439,82,28,54,34.0,66.0
15.136986301369863,73,33,40,45.0,55.0
13.886363636363637,44,21,23,48.0,52.0
13.314285714285715,35,10,25,29.0,71.0
19.434782608695652,23,3,20,13.0,87.0
17.833333333333332,18,11,7,61.0,39.0
15.625,8,2,6,25.0,75.0
9.5,2,0,2,0.0,100.0
8.4,5,2,3,40.0,60.0
11.0,1,1,0,100.0,0.0
7.25,4,3,1,75.0,25.0
12.416666666666666,12,4,8,33.0,67.0
9.130434782608695,23,10,13,43.0,57.0
17.647058823529413,51,25,26,49.0,51.0
17.535714285714285,56,28,28,50.0,50.0
12.431818181818182,44,22,22,50.0,50.0
22.0,30,15,15,50.0,50.0
31.68421052631579,19,10,9,53.0,47.0
11.724137931034482,29,14,15,48.0,52.0
20.966666666666665,30,16,14,53.0,47.0
15.533333333333333,45,23,22,51.0,49.0
23.926829268292682,41,15,26,37.0,63.0
15.04225352112676,71,30,41,42.0,58.0
15.845528455284553,123,42,81,34.0,66.0
15.185714285714285,70,31,39,44.0,56.0
13.591836734693878,49,24,25,49.0,51.0
12.424242424242424,33,11,22,33.0,67.0
12.227272727272727,22,9,13,41.0,59.0
15.0625,16,9,7,56.0,44.0
20.31578947368421,19,12,7,63.0,37.0
13.1,10,4,6,40.0,60.0
20.0,4,1,3,25.0,75.0
2.5,2,0,2,0.0,100.0
15.666666666666666,6,0,6,0.0,100.0
5.142857142857143,7,2,5,29.0,71.0
7.625,8,5,3,62.0,38.0
9.545454545454545,22,9,13,41.0,59.0
14.363636363636363,33,19,14,58.0,42.0
11.568965517241379,58,31,27,53.0,47.0
13.266666666666667,45,25,20,56.0,44.0
20.87878787878788,33,17,16,52.0,48.0
13.384615384615385,52,28,24,54.0,46.0
11.657534246575343,73,27,46,37.0,63.0
13.94,50,18,32,36.0,64.0
26.583333333333332,36,14,22,39.0,61.0
14.548387096774194,31,10,21,32.0,68.0
27.34375,64,27,37,42.0,58.0
14.510416666666666,96,57,39,59.0,41.0
10.96875,32,11,21,34.0,66.0
15.142857142857142,35,16,19,46.0,54.0
18.571428571428573,21,7,14,33.0,67.0
27.307692307692307,26,8,18,31.0,69.0
17.61111111111111,18,7,11,39.0,61.0
60.142857142857146,14,4,10,29.0,71.0
28.545454545454547,11,5,6,45.0,55.0
19.8,10,4,6,40.0,60.0
40.0,1,1,0,100.0,0.0
21.5,2,1,1,50.0,50.0
9.5,2,2,0,100.0,0.0
43.46666666666667,15,4,11,27.0,73.0
10.85,20,11,9,55.0,45.0
11.289473684210526,38,21,17,55.0,45.0
14.923076923076923,65,34,31,52.0,48.0
12.2,30,16,14,53.0,47.0
13.88888888888889,36,15,21,42.0,58.0
16.71186440677966,59,21,38,36.0,64.0
17.16393442622951,61,30,31,49.0,51.0
18.8,75,34,41,45.0,55.0
22.676470588235293,68,28,40,41.0,59.0
18.428571428571427,70,40,30,57.0,43.0
18.741573033707866,89,44,45,49.0,51.0
13.807339449541285,109,45,64,41.0,59.0
20.2987012987013,77,27,50,35.0,65.0
13.076923076923077,52,24,28,46.0,54.0
23.2,45,16,29,36.0,64.0
34.76470588235294,34,18,16,53.0,47.0
20.48,25,15,10,60.0,40.0
15.85,20,14,6,70.0,30.0
24.0,8,4,4,50.0,50.0
24.818181818181817,11,7,4,64.0,36.0
9.0,4,1,3,25.0,75.0
67.33333333333333,6,2,4,33.0,67.0
7.833333333333333,12,5,7,42.0,58.0
9.0,13,5,8,38.0,62.0
13.470588235294118,51,24,27,47.0,53.0
13.151515151515152,66,26,40,39.0,61.0
19.844444444444445,45,16,29,36.0,64.0
20.76595744680851,47,28,19,60.0,40.0
13.845238095238095,84,32,52,38.0,62.0
21.261363636363637,88,33,55,38.0,62.0
15.476923076923077,65,20,45,31.0,69.0
19.821428571428573,84,30,54,36.0,64.0
22.164556962025316,79,30,49,38.0,62.0
21.97979797979798,99,43,56,43.0,57.0
13.521739130434783,115,38,77,33.0,67.0
19.79245283018868,106,47,59,44.0,56.0
17.62264150943396,53,22,31,42.0,58.0
15.854545454545455,55,21,34,38.0,62.0
24.386363636363637,44,11,33,25.0,75.0
29.829268292682926,41,14,27,34.0,66.0
13.076923076923077,26,11,15,42.0,58.0
17.53125,32,7,25,22.0,78.0
135.42857142857142,28,6,22,21.0,79.0
17.5625,16,4,12,25.0,75.0
13.375,8,0,8,0.0,100.0
11.0,5,2,3,40.0,60.0
26.6,5,4,1,80.0,20.0
13.6,10,6,4,60.0,40.0
13.4,10,4,6,40.0,60.0
40.23809523809524,21,8,13,38.0,62.0
21.13157894736842,38,13,25,34.0,66.0
22.116883116883116,77,21,56,27.0,73.0
33.851485148514854,101,25,76,25.0,75.0
26.28205128205128,78,16,62,21.0,79.0
26.063157894736843,95,25,70,26.0,74.0
22.789473684210527,95,26,69,27.0,73.0
40.49425287356322,87,13,74,15.0,85.0
30.333333333333332,84,25,59,30.0,70.0
14.203389830508474,59,25,34,42.0,58.0
49.774647887323944,71,31,40,44.0,56.0
16.926829268292682,41,9,32,22.0,78.0
24.476190476190474,42,17,25,40.0,60.0
16.081632653061224,49,17,32,35.0,65.0
15.64864864864865,37,13,24,35.0,65.0
18.26086956521739,23,8,15,35.0,65.0
10.4,10,5,5,50.0,50.0
8.545454545454545,11,5,6,45.0,55.0
12.625,8,3,5,38.0,62.0
23.333333333333332,3,2,1,67.0,33.0
8.666666666666666,3,2,1,67.0,33.0
54.0,4,2,2,50.0,50.0
13.666666666666666,3,2,1,67.0,33.0
19.5,8,4,4,50.0,50.0
16.1,20,6,14,30.0,70.0
23.692307692307693,26,12,14,46.0,54.0
13.75,32,8,24,25.0,75.0
18.23404255319149,47,21,26,45.0,55.0
17.836734693877553,49,13,36,27.0,73.0
20.912280701754387,57,12,45,21.0,79.0
30.12676056338028,71,16,55,23.0,77.0
25.571428571428573,77,16,61,21.0,79.0
25.355263157894736,76,21,55,28.0,72.0
22.91549295774648,71,20,51,28.0,72.0
19.29850746268657,67,29,38,43.0,57.0
16.256410256410255,78,32,46,41.0,59.0
24.875,40,16,24,40.0,60.0
13.454545454545455,22,12,10,55.0,45.0
20.615384615384617,26,7,19,27.0,73.0
17.41176470588235,17,8,9,47.0,53.0
15.4,5,2,3,40.0,60.0
12.75,4,3,1,75.0,25.0
24.333333333333332,3,1,2,33.0,67.0
5.0,2,0,2,0.0,100.0
9.166666666666666,6,4,2,67.0,33.0
8.166666666666666,6,3,3,50.0,50.0
35.94117647058823,17,7,10,41.0,59.0
8.54054054054054,37,17,20,46.0,54.0
11.0,74,37,37,50.0,50.0
18.975609756097562,41,14,27,34.0,66.0
23.53488372093023,43,20,23,47.0,53.0
19.26865671641791,67,23,44,34.0,66.0
19.071428571428573,56,17,39,30.0,70.0
29.876404494382022,89,41,48,46.0,54.0
16.982456140350877,57,21,36,37.0,63.0
20.59016393442623,61,27,34,44.0,56.0
31.671232876712327,73,31,42,42.0,58.0
14.681818181818182,110,49,61,45.0,55.0
31.32608695652174,92,39,53,42.0,58.0
57.054545454545455,55,25,30,45.0,55.0
10.333333333333334,33,15,18,45.0,55.0
29.647058823529413,34,13,21,38.0,62.0
23.321428571428573,28,8,20,29.0,71.0
20.5,12,5,7,42.0,58.0
7.4,5,0,5,0.0,100.0
33.333333333333336,3,1,2,33.0,67.0
9.0,4,1,3,25.0,75.0
4.0,1,0,1,0.0,100.0
14.142857142857142,7,2,5,29.0,71.0
9.777777777777779,9,5,4,56.0,44.0
8.45,20,5,15,25.0,75.0
12.282608695652174,46,17,29,37.0,63.0
15.025316455696203,79,38,41,48.0,52.0
18.81132075471698,53,21,32,40.0,60.0
22.244897959183675,49,15,34,31.0,69.0
20.428571428571427,42,14,28,33.0,67.0
15.846153846153847,65,18,47,28.0,72.0
39.464285714285715,56,14,42,25.0,75.0
23.27027027027027,74,25,49,34.0,66.0
21.52238805970149,67,27,40,40.0,60.0
29.22429906542056,107,48,59,45.0,55.0
24.180555555555557,144,50,94,35.0,65.0
20.836363636363636,110,51,59,46.0,54.0
14.767857142857142,56,25,31,45.0,55.0
20.57777777777778,45,22,23,49.0,51.0
13.35483870967742,31,13,18,42.0,58.0
18.57894736842105,38,9,29,24.0,76.0
53.3,30,10,20,33.0,67.0
22.88888888888889,9,6,3,67.0,33.0
7.857142857142857,7,6,1,86.0,14.0
10.333333333333334,3,0,3,0.0,100.0
6.0,1,0,1,0.0,100.0
4.0,2,1,1,50.0,50.0
7.545454545454546,11,3,8,27.0,73.0
10.357142857142858,14,5,9,36.0,64.0
11.18867924528302,53,23,30,43.0,57.0
16.46153846153846,78,36,42,46.0,54.0
21.854166666666668,48,25,23,52.0,48.0
19.023255813953487,43,19,24,44.0,56.0
28.166666666666668,66,26,40,39.0,61.0
18.567164179104477,67,21,46,31.0,69.0
16.38095238095238,63,30,33,48.0,52.0
15.490196078431373,51,27,24,53.0,47.0
26.333333333333332,63,25,38,40.0,60.0
18.45263157894737,95,40,55,42.0,58.0
13.503703703703703,135,55,80,41.0,59.0
14.8,100,40,60,40.0,60.0
15.376811594202898,69,27,42,39.0,61.0
18.742857142857144,35,18,17,51.0,49.0
10.069767441860465,43,16,27,37.0,63.0
14.735294117647058,34,7,27,21.0,79.0
13.666666666666666,18,11,7,61.0,39.0
10.5,8,1,7,12.0,88.0
14.5,2,1,1,50.0,50.0
12.0,3,2,1,67.0,33.0
15.0,1,1,0,100.0,0.0
66.33333333333333,3,1,2,33.0,67.0
8.555555555555555,9,3,6,33.0,67.0
8.764705882352942,17,6,11,35.0,65.0
17.29824561403509,57,24,33,42.0,58.0
11.244186046511627,86,44,42,51.0,49.0
13.25,56,31,25,55.0,45.0
20.157894736842106,38,13,25,34.0,66.0
17.369565217391305,46,19,27,41.0,59.0
21.58730158730159,63,24,39,38.0,62.0
17.318840579710145,69,30,39,43.0,57.0
18.180555555555557,72,31,41,43.0,57.0
18.681818181818183,88,44,44,50.0,50.0
15.867469879518072,83,42,41,51.0,49.0
17.224137931034484,116,48,68,41.0,59.0
16.242424242424242,99,44,55,44.0,56.0
24.35211267605634,71,29,42,41.0,59.0
19.19148936170213,47,16,31,34.0,66.0
17.076923076923077,39,19,20,49.0,51.0
18.5,34,9,25,26.0,74.0
10.866666666666667,15,9,6,60.0,40.0
25.875,8,5,3,62.0,38.0
10.9,10,5,5,50.0,50.0
8.666666666666666,3,2,1,67.0,33.0
15.5,2,1,1,50.0,50.0
7.0,3,1,2,33.0,67.0
9.181818181818182,11,5,6,45.0,55.0
7.3125,16,8,8,50.0,50.0
9.463414634146341,41,19,22,46.0,54.0
14.816901408450704,71,31,40,44.0,56.0
18.979591836734695,49,24,25,49.0,51.0
17.11111111111111,54,24,30,44.0,56.0
18.83050847457627,59,28,31,47.0,53.0
27.852272727272727,88,40,48,45.0,55.0
18.543478260869566,92,40,52,43.0,57.0
23.5,82,27,55,33.0,67.0
24.253012048192772,83,32,51,39.0,61.0
18.540983606557376,122,49,73,40.0,60.0
20.046296296296298,108,43,65,40.0,60.0
19.614583333333332,96,31,65,32.0,68.0
15.166666666666666,60,19,41,32.0,68.0
15.225806451612904,31,11,20,35.0,65.0
22.23404255319149,47,16,31,34.0,66.0
13.8,25,11,14,44.0,56.0
18.74074074074074,27,11,16,41.0,59.0
23.03846153846154,26,12,14,46.0,54.0
16.555555555555557,9,4,5,44.0,56.0
31.333333333333332,9,3,6,33.0,67.0
3.0,1,0,1,0.0,100.0
14.6,5,3,2,60.0,40.0
8.0,1,0,1,0.0,100.0
6.666666666666667,3,3,0,100.0,0.0
7.363636363636363,11,6,5,55.0,45.0
14.538461538461538,26,11,15,42.0,58.0
30.136363636363637,44,13,31,30.0,70.0
23.83823529411765,68,23,45,34.0,66.0
16.4468085106383,47,18,29,38.0,62.0
12.96774193548387,31,18,13,58.0,42.0
26.78787878787879,33,19,14,58.0,42.0
34.568627450980394,51,13,38,25.0,75.0
21.017241379310345,58,20,38,34.0,66.0
25.125,88,24,64,27.0,73.0
23.492753623188406,69,18,51,26.0,74.0
24.3,80,25,55,31.0,69.0
13.686274509803921,51,23,28,45.0,55.0
15.525,40,15,25,38.0,62.0
13.86111111111111,36,16,20,44.0,56.0
25.28846153846154,52,11,41,21.0,79.0
15.19047619047619,21,11,10,52.0,48.0
15.210526315789474,19,10,9,53.0,47.0
136.5,10,7,3,70.0,30.0
25.545454545454547,11,5,6,45.0,55.0
14.333333333333334,3,1,2,33.0,67.0
9.666666666666666,3,2,1,67.0,33.0
4.666666666666667,3,1,2,33.0,67.0
6.25,8,3,5,38.0,62.0
10.882352941176471,17,8,9,47.0,53.0
22.238095238095237,21,4,17,19.0,81.0
17.77777777777778,45,19,26,42.0,58.0
59.44927536231884,69,21,48,30.0,70.0
36.83098591549296,71,20,51,28.0,72.0
40.127450980392155,102,28,74,27.0,73.0
36.168539325842694,89,22,67,25.0,75.0
29.5,96,21,75,22.0,78.0
24.17924528301887,106,37,69,35.0,65.0
27.080357142857142,112,31,81,28.0,72.0
26.303030303030305,66,23,43,35.0,65.0
24.080459770114942,87,43,44,49.0,51.0
16.672131147540984,61,29,32,48.0,52.0
13.785714285714286,28,17,11,61.0,39.0
14.555555555555555,18,13,5,72.0,28.0
18.363636363636363,22,6,16,27.0,73.0
14.571428571428571,14,9,5,64.0,36.0
123.5,8,4,4,50.0,50.0
18.25,4,1,3,25.0,75.0
7.0,3,0,3,0.0,100.0
9.0,2,2,0,100.0,0.0
8.666666666666666,12,9,3,75.0,25.0
8.894736842105264,19,7,12,37.0,63.0
16.53191489361702,47,24,23,51.0,49.0
11.573333333333334,75,33,42,44.0,56.0
16.140350877192983,57,26,31,46.0,54.0
19.714285714285715,42,20,22,48.0,52.0
21.581818181818182,55,20,35,36.0,64.0
23.902439024390244,82,27,55,33.0,67.0
22.213333333333335,75,33,42,44.0,56.0
44.89230769230769,65,25,40,38.0,62.0
22.957894736842107,95,50,45,53.0,47.0
44.189473684210526,95,49,46,52.0,48.0
13.153284671532846,137,56,81,41.0,59.0
13.698795180722891,83,43,40,52.0,48.0
16.363636363636363,55,28,27,51.0,49.0
17.307692307692307,39,17,22,44.0,56.0
9.7,30,12,18,40.0,60.0
9.909090909090908,22,10,12,45.0,55.0
18.285714285714285,7,4,3,57.0,43.0
23.4,10,3,7,30.0,70.0
8.0,3,2,1,67.0,33.0
8.0,1,1,0,100.0,0.0
8.0,1,0,1,0.0,100.0
19.0,5,2,3,40.0,60.0
9.3,10,7,3,70.0,30.0
8.61111111111111,18,5,13,28.0,72.0
10.947368421052632,57,26,31,46.0,54.0
16.845070422535212,71,31,40,44.0,56.0
16.72222222222222,54,26,28,48.0,52.0
17.25,48,20,28,42.0,58.0
14.646153846153846,65,26,39,40.0,60.0
14.566666666666666,60,23,37,38.0,62.0
13.608695652173912,69,31,38,45.0,55.0
20.220338983050848,59,29,30,49.0,51.0
17.545454545454547,66,29,37,44.0,56.0
16.107526881720432,93,39,54,42.0,58.0
20.755395683453237,139,53,86,38.0,62.0
14.657894736842104,114,50,64,44.0,56.0
13.666666666666666,57,25,32,44.0,56.0
19.594594594594593,37,14,23,38.0,62.0
12.153846153846153,39,15,24,38.0,62.0
18.285714285714285,28,9,19,32.0,68.0
12.916666666666666,24,8,16,33.0,67.0
7.333333333333333,9,6,3,67.0,33.0
10.5,4,3,1,75.0,25.0
12.0,1,0,1,0.0,100.0
8.75,4,2,2,50.0,50.0
5.0,2,1,1,50.0,50.0
20.77777777777778,9,4,5,44.0,56.0
12.05,20,3,17,15.0,85.0
11.208333333333334,48,22,26,46.0,54.0
12.543478260869565,92,46,46,50.0,50.0
18.1,70,37,33,53.0,47.0
15.508196721311476,61,24,37,39.0,61.0
18.6,65,27,38,42.0,58.0
18.34090909090909,88,37,51,42.0,58.0
14.929824561403509,57,26,31,46.0,54.0
24.823529411764707,68,26,42,38.0,62.0
19.223684210526315,76,35,41,46.0,54.0
17.806451612903224,93,41,52,44.0,56.0
21.660869565217393,115,48,67,42.0,58.0
41.76,100,44,56,44.0,56.0
20.46969696969697,66,28,38,42.0,58.0
11.568181818181818,44,15,29,34.0,66.0
16.714285714285715,42,22,20,52.0,48.0
11.1,30,14,16,47.0,53.0
23.5,10,4,6,40.0,60.0
11.25,8,4,4,50.0,50.0
22.0,5,3,2,60.0,40.0
8.25,4,1,3,25.0,75.0
4.333333333333333,3,0,3,0.0,100.0
6.8,10,6,4,60.0,40.0
12.0,13,2,11,15.0,85.0
11.0,45,20,25,44.0,56.0
13.064102564102564,78,40,38,51.0,49.0
14.887096774193548,62,31,31,50.0,50.0
15.575,40,16,24,40.0,60.0
17.5,46,20,26,43.0,57.0
21.56578947368421,76,41,35,54.0,46.0
16.279411764705884,68,30,38,44.0,56.0
17.77358490566038,53,26,27,49.0,51.0
16.475409836065573,61,26,35,43.0,57.0
18.908333333333335,120,49,71,41.0,59.0
20.18018018018018,111,40,71,36.0,64.0
15.206185567010309,97,43,54,44.0,56.0
27.9375,64,28,36,44.0,56.0
13.26923076923077,52,24,28,46.0,54.0
22.891304347826086,46,14,32,30.0,70.0
14.48,25,12,13,48.0,52.0
16.555555555555557,18,7,11,39.0,61.0
107.2,15,8,7,53.0,47.0
18.375,8,3,5,38.0,62.0
11.5,6,2,4,33.0,67.0
11.0,5,3,2,60.0,40.0
3.3333333333333335,3,2,1,67.0,33.0
9.0,11,5,6,45.0,55.0
9.15,20,8,12,40.0,60.0
10.716666666666667,60,31,29,52.0,48.0
13.594594594594595,74,32,42,43.0,57.0
20.114754098360656,61,34,27,56.0,44.0
23.41176470588235,51,24,27,47.0,53.0
24.615384615384617,78,36,42,46.0,54.0
30.64788732394366,71,29,42,41.0,59.0
37.13253012048193,83,23,60,28.0,72.0
39.17821782178218,101,37,64,37.0,63.0
26.71212121212121,132,47,85,36.0,64.0
27.175257731958762,97,40,57,41.0,59.0
20.06,100,40,60,40.0,60.0
18.016393442622952,122,49,73,40.0,60.0
31.084745762711865,59,18,41,31.0,69.0
20.345454545454544,55,28,27,51.0,49.0
18.513513513513512,74,28,46,38.0,62.0
26.746478873239436,71,25,46,35.0,65.0
18.796296296296298,54,11,43,20.0,80.0
27.073170731707318,41,18,23,44.0,56.0
24.06896551724138,29,8,21,28.0,72.0
29.6,15,2,13,13.0,87.0
16.4,5,2,3,40.0,60.0
43.333333333333336,6,1,5,17.0,83.0
4.4,5,3,2,60.0,40.0
19.0,10,8,2,80.0,20.0
33.22222222222222,18,6,12,33.0,67.0
15.884615384615385,26,16,10,62.0,38.0
25.130434782608695,46,19,27,41.0,59.0
24.370967741935484,62,26,36,42.0,58.0
24.01492537313433,67,24,43,36.0,64.0
32.274193548387096,62,17,45,27.0,73.0
22.16,75,31,44,41.0,59.0
25.6,80,22,58,28.0,72.0
22.705128205128204,78,18,60,23.0,77.0
24.73015873015873,63,21,42,33.0,67.0
31.608695652173914,92,31,61,34.0,66.0
17.54054054054054,37,14,23,38.0,62.0
40.43333333333333,30,7,23,23.0,77.0
20.766666666666666,30,12,18,40.0,60.0
15.035714285714286,28,5,23,18.0,82.0
15.607142857142858,28,8,20,29.0,71.0
23.35135135135135,37,12,25,32.0,68.0
14.777777777777779,27,6,21,22.0,78.0
16.857142857142858,21,12,9,57.0,43.0
9.125,8,3,5,38.0,62.0
13.0,2,1,1,50.0,50.0
124.66666666666667,3,2,1,67.0,33.0
5.5,2,0,2,0.0,100.0
4.6,10,3,7,30.0,70.0
26.214285714285715,14,5,9,36.0,64.0
25.875,16,5,11,31.0,69.0
17.03125,32,12,20,38.0,62.0
21.78787878787879,33,10,23,30.0,70.0
24.42105263157895,38,14,24,37.0,63.0
19.833333333333332,48,19,29,40.0,60.0
26.725806451612904,62,14,48,23.0,77.0
28.26984126984127,63,20,43,32.0,68.0
19.86111111111111,72,31,41,43.0,57.0
21.564102564102566,78,27,51,35.0,65.0
18.5,72,23,49,32.0,68.0
20.28125,64,22,42,34.0,66.0
12.674418604651162,43,13,30,30.0,70.0
32.925925925925924,27,7,20,26.0,74.0
25.27777777777778,18,8,10,44.0,56.0
22.08,25,15,10,60.0,40.0
18.764705882352942,17,5,12,29.0,71.0
30.416666666666668,12,4,8,33.0,67.0
90.66666666666667,3,2,1,67.0,33.0
27.0,4,1,3,25.0,75.0
47.0,2,0,2,0.0,100.0
5.0,1,1,0,100.0,0.0
12.714285714285714,14,9,5,64.0,36.0
14.133333333333333,15,7,8,47.0,53.0
14.173913043478262,46,24,22,52.0,48.0
11.631578947368421,76,37,39,49.0,51.0
13.405797101449275,69,40,29,58.0,42.0
20.13157894736842,38,16,22,42.0,58.0
16.93877551020408,49,23,26,47.0,53.0
18.633802816901408,71,33,38,46.0,54.0
17.28985507246377,69,27,42,39.0,61.0
19.545454545454547,44,26,18,59.0,41.0
20.092307692307692,65,29,36,45.0,55.0
16.567901234567902,81,42,39,52.0,48.0
16.1171875,128,59,69,46.0,54.0
13.333333333333334,84,43,41,51.0,49.0
21.473684210526315,38,16,22,42.0,58.0
14.560975609756097,41,21,20,51.0,49.0
14.941176470588236,34,17,17,50.0,50.0
17.5,16,12,4,75.0,25.0
16.071428571428573,14,7,7,50.0,50.0
15.333333333333334,6,4,2,67.0,33.0
9.25,4,1,3,25.0,75.0
32.2,5,2,3,40.0,60.0
8.5,2,1,1,50.0,50.0
7.333333333333333,6,2,4,33.0,67.0
9.666666666666666,12,8,4,67.0,33.0
9.952380952380953,21,11,10,52.0,48.0
13.0,57,27,30,47.0,53.0
12.22972972972973,74,40,34,54.0,46.0
21.96,50,24,26,48.0,52.0
20.377777777777776,45,22,23,49.0,51.0
19.120481927710845,83,42,41,51.0,49.0
31.0,71,34,37,48.0,52.0
16.70967741935484,62,33,29,53.0,47.0
29.676470588235293,68,26,42,38.0,62.0
16.49367088607595,79,28,51,35.0,65.0
17.5,80,32,48,40.0,60.0
14.444444444444445,117,58,59,50.0,50.0
15.438095238095238,105,51,54,49.0,51.0
17.980392156862745,51,21,30,41.0,59.0
13.886363636363637,44,29,15,66.0,34.0
29.487179487179485,39,16,23,41.0,59.0
15.5625,16,7,9,44.0,56.0
9.909090909090908,11,3,8,27.0,73.0
9.0,6,2,4,33.0,67.0
14.666666666666666,6,4,2,67.0,33.0
9.8,5,4,1,80.0,20.0
26.5,2,2,0,100.0,0.0
23.0,4,3,1,75.0,25.0
17.0,10,3,7,30.0,70.0
11.227272727272727,22,9,13,41.0,59.0
9.75,52,29,23,56.0,44.0
14.870588235294118,85,42,43,49.0,51.0
11.65,60,36,24,60.0,40.0
24.923076923076923,52,22,30,42.0,58.0
18.91780821917808,73,29,44,40.0,60.0
28.171717171717173,99,45,54,45.0,55.0
18.070422535211268,71,41,30,58.0,42.0
17.0,51,18,33,35.0,65.0
20.75,68,37,31,54.0,46.0
14.221153846153847,104,47,57,45.0,55.0
12.138211382113822,123,60,63,49.0,51.0
12.333333333333334,78,33,45,42.0,58.0
12.680851063829786,47,19,28,40.0,60.0
10.98076923076923,52,30,22,58.0,42.0
15.1,30,14,16,47.0,53.0
36.63636363636363,22,10,12,45.0,55.0
25.11111111111111,18,9,9,50.0,50.0
1.0,1,0,1,0.0,100.0
15.8,5,1,4,20.0,80.0
9.0,3,2,1,67.0,33.0
10.0,3,2,1,67.0,33.0
9.5,4,2,2,50.0,50.0
9.142857142857142,14,6,8,43.0,57.0
14.058823529411764,17,8,9,47.0,53.0
11.11111111111111,45,25,20,56.0,44.0
11.867647058823529,68,35,33,51.0,49.0
18.053333333333335,75,38,37,51.0,49.0
23.09433962264151,53,30,23,57.0,43.0
20.295081967213115,61,27,34,44.0,56.0
10.909090909090908,66,29,37,44.0,56.0
13.015625,64,37,27,58.0,42.0
33.14473684210526,76,37,39,49.0,51.0
15.903225806451612,62,29,33,47.0,53.0
15.870967741935484,93,51,42,55.0,45.0
17.78494623655914,93,34,59,37.0,63.0
16.25,92,50,42,54.0,46.0
20.666666666666668,60,28,32,47.0,53.0
12.527777777777779,36,20,16,56.0,44.0
19.0,44,28,16,64.0,36.0
16.0,21,7,14,33.0,67.0
11.9,20,8,12,40.0,60.0
13.76923076923077,13,9,4,69.0,31.0
10.333333333333334,9,6,3,67.0,33.0
3.0,1,1,0,100.0,0.0
48.0,2,2,0,100.0,0.0
12.333333333333334,3,2,1,67.0,33.0
19.90909090909091,11,8,3,73.0,27.0
13.8125,16,7,9,44.0,56.0
8.702702702702704,37,18,19,49.0,51.0
42.0,52,28,24,54.0,46.0
9.958333333333334,24,13,11,54.0,46.0
11.434782608695652,23,14,9,61.0,39.0
10.777777777777779,27,15,12,56.0,44.0
10.956521739130435,23,11,12,48.0,52.0
13.88888888888889,18,10,8,56.0,44.0
7.05,20,13,7,65.0,35.0
24.52173913043478,23,9,14,39.0,61.0
14.783783783783784,37,15,22,41.0,59.0
11.425531914893616,47,19,28,40.0,60.0
14.266666666666667,45,15,30,33.0,67.0
13.172413793103448,29,12,17,41.0,59.0
14.074074074074074,27,10,17,37.0,63.0
9.764705882352942,17,10,7,59.0,41.0
11.476190476190476,21,12,9,57.0,43.0
13.2,15,8,7,53.0,47.0
10.5,6,3,3,50.0,50.0
10.5,2,2,0,100.0,0.0
19.0,2,1,1,50.0,50.0
30.666666666666668,3,2,1,67.0,33.0
6.0,1,1,0,100.0,0.0
11.333333333333334,3,3,0,100.0,0.0
7.5,4,3,1,75.0,25.0
11.083333333333334,12,7,5,58.0,42.0
13.6,15,9,6,60.0,40.0
19.419354838709676,31,9,22,29.0,71.0
14.833333333333334,48,25,23,52.0,48.0
31.96969696969697,66,19,47,29.0,71.0
26.0,86,25,61,29.0,71.0
18.40277777777778,72,19,53,26.0,74.0
20.58974358974359,78,24,54,31.0,69.0
17.121951219512194,82,14,68,17.0,83.0
21.63235294117647,68,20,48,29.0,71.0
18.376470588235293,85,25,60,29.0,71.0
18.425,80,27,53,34.0,66.0
15.91891891891892,37,16,21,43.0,57.0
21.0,26,17,9,65.0,35.0
112.13513513513513,37,17,20,46.0,54.0
32.86206896551724,29,16,13,55.0,45.0
27.533333333333335,30,11,19,37.0,63.0
11.5,12,3,9,25.0,75.0
11.714285714285714,7,3,4,43.0,57.0
17.5,2,0,2,0.0,100.0
13.5,2,0,2,0.0,100.0
19.333333333333332,6,3,3,50.0,50.0
10.5,8,6,2,75.0,25.0
11.8125,16,9,7,56.0,44.0
43.15384615384615,26,11,15,42.0,58.0
18.571428571428573,28,13,15,46.0,54.0
22.115384615384617,26,9,17,35.0,65.0
16.434782608695652,23,10,13,43.0,57.0
37.40625,32,12,20,38.0,62.0
19.058823529411764,17,8,9,47.0,53.0
18.416666666666668,24,10,14,42.0,58.0
13.857142857142858,35,8,27,23.0,77.0
16.74074074074074,54,29,25,54.0,46.0
23.173076923076923,52,13,39,25.0,75.0
14.826086956521738,23,10,13,43.0,57.0
14.5,24,7,17,29.0,71.0
13.642857142857142,14,5,9,36.0,64.0
12.333333333333334,9,5,4,56.0,44.0
86.42857142857143,7,4,3,57.0,43.0
33.888888888888886,9,3,6,33.0,67.0
15.714285714285714,7,2,5,29.0,71.0
9.666666666666666,3,1,2,33.0,67.0
14.8,5,2,3,40.0,60.0
82.5,2,2,0,100.0,0.0
22.5,2,2,0,100.0,0.0
13.0,10,5,5,50.0,50.0
12.375,8,2,6,25.0,75.0
10.264705882352942,34,21,13,62.0,38.0
17.13953488372093,43,19,24,44.0,56.0
16.192307692307693,26,15,11,58.0,42.0
32.68,25,13,12,52.0,48.0
21.75862068965517,29,10,19,34.0,66.0
12.121212121212121,33,14,19,42.0,58.0
34.46938775510204,49,25,24,51.0,49.0
15.026315789473685,38,13,25,34.0,66.0
20.393939393939394,33,17,16,52.0,48.0
14.685185185185185,54,30,24,56.0,44.0
29.295081967213115,61,36,25,59.0,41.0
15.4,65,29,36,45.0,55.0
14.129032258064516,31,8,23,26.0,74.0
34.32258064516129,31,13,18,42.0,58.0
11.083333333333334,24,13,11,54.0,46.0
10.714285714285714,14,7,7,50.0,50.0
9.7,10,3,7,30.0,70.0
16.75,12,5,7,42.0,58.0
11.666666666666666,6,4,2,67.0,33.0
15.0,2,1,1,50.0,50.0
11.5,2,1,1,50.0,50.0
9.666666666666666,3,1,2,33.0,67.0
10.166666666666666,6,4,2,67.0,33.0
14.095238095238095,21,6,15,29.0,71.0
13.31578947368421,38,19,19,50.0,50.0
13.085714285714285,70,33,37,47.0,53.0
12.962264150943396,53,30,23,57.0,43.0
16.73076923076923,26,13,13,50.0,50.0
14.0,46,25,21,54.0,46.0
18.671232876712327,73,36,37,49.0,51.0
14.409090909090908,66,34,32,52.0,48.0
22.574074074074073,54,28,26,52.0,48.0
32.50769230769231,65,37,28,57.0,43.0
18.357894736842105,95,54,41,57.0,43.0
14.5,102,42,60,41.0,59.0
17.044444444444444,90,51,39,57.0,43.0
15.733333333333333,30,7,23,23.0,77.0
12.375,40,29,11,72.0,28.0
8.933333333333334,30,19,11,63.0,37.0
13.105263157894736,19,8,11,42.0,58.0
18.5625,16,8,8,50.0,50.0
10.6,10,7,3,70.0,30.0
30.75,4,1,3,25.0,75.0
4.0,2,1,1,50.0,50.0
12.090909090909092,11,5,6,45.0,55.0
10.333333333333334,21,6,15,29.0,71.0
10.871794871794872,39,20,19,51.0,49.0
14.03076923076923,65,34,31,52.0,48.0
20.327272727272728,55,32,23,58.0,42.0
14.485714285714286,35,22,13,63.0,37.0
21.727272727272727,55,35,20,64.0,36.0
14.323529411764707,68,38,30,56.0,44.0
23.75409836065574,61,27,34,44.0,56.0
20.24,50,21,29,42.0,58.0
26.154929577464788,71,29,42,41.0,59.0
17.797619047619047,84,49,35,58.0,42.0
14.00943396226415,106,49,57,46.0,54.0
15.376344086021506,93,48,45,52.0,48.0
17.651162790697676,43,23,20,53.0,47.0
12.21951219512195,41,20,21,49.0,51.0
11.229166666666666,48,23,25,48.0,52.0
21.88888888888889,18,9,9,50.0,50.0
16.785714285714285,14,5,9,36.0,64.0
12.9,10,2,8,20.0,80.0
16.666666666666668,6,2,4,33.0,67.0
25.0,3,1,2,33.0,67.0
56.0,1,1,0,100.0,0.0
250.0,3,2,1,67.0,33.0
8.0,9,4,5,44.0,56.0
12.38888888888889,18,9,9,50.0,50.0
14.882352941176471,51,24,27,47.0,53.0
11.285714285714286,70,34,36,49.0,51.0
15.818181818181818,66,42,24,64.0,36.0
23.70731707317073,41,20,21,49.0,51.0
15.232142857142858,56,22,34,39.0,61.0
21.323076923076922,65,22,43,34.0,66.0
24.428571428571427,77,36,41,47.0,53.0
20.238805970149254,67,35,32,52.0,48.0
18.850574712643677,87,34,53,39.0,61.0
17.055555555555557,90,39,51,43.0,57.0
27.25563909774436,133,48,85,36.0,64.0
20.5,94,33,61,35.0,65.0
20.232558139534884,43,18,25,42.0,58.0
14.2,40,16,24,40.0,60.0
14.538461538461538,39,10,29,26.0,74.0
18.5,22,8,14,36.0,64.0
12.869565217391305,23,12,11,52.0,48.0
16.727272727272727,11,5,6,45.0,55.0
14.333333333333334,9,3,6,33.0,67.0
21.5,6,3,3,50.0,50.0
8.0,1,0,1,0.0,100.0
12.0,2,0,2,0.0,100.0
9.714285714285714,7,6,1,86.0,14.0
9.615384615384615,13,5,8,38.0,62.0
13.85,40,17,23,42.0,57.0
15.024691358024691,81,38,43,47.0,53.0
13.782608695652174,46,19,27,41.0,59.0
22.244444444444444,45,23,22,51.0,49.0
18.70967741935484,62,23,39,37.0,63.0
18.046153846153846,65,22,43,34.0,66.0
17.89189189189189,74,21,53,28.0,72.0
48.975,80,29,51,36.0,64.0
22.58695652173913,92,34,58,37.0,63.0
22.388489208633093,139,47,92,34.0,66.0
19.1937984496124,129,61,68,47.0,53.0
25.8989898989899,99,52,47,53.0,47.0
19.473684210526315,57,26,31,46.0,54.0
26.375,32,10,22,31.0,69.0
23.254545454545454,55,16,39,29.0,71.0
15.18867924528302,53,28,25,53.0,47.0
27.34375,32,15,17,47.0,53.0
27.79310344827586,29,12,17,41.0,59.0
15.642857142857142,14,6,8,43.0,57.0
104.53846153846153,13,5,8,38.0,62.0
76.0,1,1,0,100.0,0.0
16.0,5,2,3,40.0,60.0
17.285714285714285,7,1,6,14.0,86.0
8.4,15,8,7,53.0,47.0
15.5,14,6,8,43.0,57.0
25.372549019607842,51,17,34,33.0,67.0
22.215686274509803,51,15,36,29.0,71.0
19.53731343283582,67,27,40,40.0,60.0
73.32,75,27,48,36.0,64.0
29.951219512195124,82,28,54,34.0,66.0
28.454545454545453,88,26,62,30.0,70.0
45.027522935779814,109,36,73,33.0,67.0
22.082474226804123,97,29,68,30.0,70.0
33.48421052631579,95,32,63,34.0,66.0
14.56,75,31,44,41.0,59.0
16.347826086956523,46,15,31,33.0,67.0
28.274509803921568,51,14,37,27.0,73.0
25.085714285714285,35,7,28,20.0,80.0
26.575757575757574,33,5,28,15.0,85.0
25.916666666666668,24,8,16,33.0,67.0
10.73913043478261,23,9,14,39.0,61.0
10.1,10,6,4,60.0,40.0
70.07142857142857,14,11,3,79.0,21.0
3.0,3,2,1,67.0,33.0
35.333333333333336,3,1,2,33.0,67.0
23.0,1,0,1,0.0,100.0
17.083333333333332,12,4,8,33.0,67.0
13.083333333333334,12,6,6,50.0,50.0
16.956521739130434,23,8,15,35.0,65.0
22.73170731707317,41,15,26,37.0,63.0
21.404255319148938,47,17,30,36.0,64.0
21.029411764705884,68,20,48,29.0,71.0
28.07017543859649,57,18,39,32.0,68.0
25.860759493670887,79,30,49,38.0,62.0
26.67058823529412,85,26,59,31.0,69.0
20.571428571428573,84,32,52,38.0,62.0
29.839506172839506,81,25,56,31.0,69.0
19.294117647058822,85,22,63,26.0,74.0
21.139240506329113,79,28,51,35.0,65.0
25.414634146341463,41,19,22,46.0,54.0
16.366666666666667,30,19,11,63.0,37.0
75.33333333333333,33,11,22,33.0,67.0
14.736842105263158,19,5,14,26.0,74.0
12.473684210526315,19,12,7,63.0,37.0
20.5,6,2,4,33.0,67.0
16.833333333333332,6,4,2,67.0,33.0
16.5,2,1,1,50.0,50.0
13.0,1,0,1,0.0,100.0
7.0,2,1,1,50.0,50.0
8.875,8,6,2,75.0,25.0
25.833333333333332,18,8,10,44.0,56.0
13.44,50,25,25,50.0,50.0
17.47887323943662,71,35,36,49.0,51.0
14.604166666666666,48,16,32,33.0,67.0
13.236842105263158,38,22,16,58.0,42.0
16.24074074074074,54,34,20,63.0,37.0
16.152542372881356,59,29,30,49.0,51.0
12.342857142857143,70,36,34,51.0,49.0
18.17391304347826,46,24,22,52.0,48.0
20.098039215686274,51,25,26,49.0,51.0
18.21505376344086,93,47,46,51.0,49.0
14.580357142857142,112,59,53,53.0,47.0
13.317460317460318,63,26,37,41.0,59.0
18.62,50,30,20,60.0,40.0
28.976744186046513,43,27,16,63.0,37.0
20.025641025641026,39,20,19,51.0,49.0
83.78571428571429,28,15,13,54.0,46.0
24.166666666666668,12,5,7,42.0,58.0
15.571428571428571,7,6,1,86.0,14.0
19.4,5,2,3,40.0,60.0
5.0,1,1,0,100.0,0.0
14.0,2,2,0,100.0,0.0
104.5,4,3,1,75.0,25.0
13.583333333333334,12,6,6,50.0,50.0
12.166666666666666,12,4,8,33.0,67.0
11.745098039215685,51,25,26,49.0,51.0
35.883116883116884,77,43,34,56.0,44.0
33.94642857142857,56,28,28,50.0,50.0
18.625,48,24,24,50.0,50.0
18.01818181818182,55,24,31,44.0,56.0
15.25,56,22,34,39.0,61.0
20.855263157894736,76,32,44,42.0,58.0
27.046153846153846,65,23,42,35.0,65.0
16.83076923076923,65,33,32,51.0,49.0
17.910112359550563,89,39,50,44.0,56.0
14.621848739495798,119,48,71,40.0,60.0
15.916666666666666,72,35,37,49.0,51.0
13.604651162790697,43,20,23,47.0,53.0
15.090909090909092,33,20,13,61.0,39.0
13.382352941176471,34,18,16,53.0,47.0
12.75,12,6,6,50.0,50.0
15.2,15,12,3,80.0,20.0
10.3,10,4,6,40.0,60.0
22.5,4,2,2,50.0,50.0
15.0,1,0,1,0.0,100.0
12.0,5,3,2,60.0,40.0
8.6,5,2,3,40.0,60.0
10.75,8,2,6,25.0,75.0
9.476190476190476,21,8,13,38.0,62.0
9.12280701754386,57,31,26,54.0,46.0
12.285714285714286,70,43,27,61.0,39.0
13.016129032258064,62,35,27,56.0,44.0
17.738095238095237,42,21,21,50.0,50.0
9.088235294117647,34,18,16,53.0,47.0
18.93846153846154,65,38,27,58.0,42.0
13.253968253968255,63,34,29,54.0,46.0
58.65625,64,37,27,58.0,42.0
22.083333333333332,60,38,22,63.0,37.0
19.906976744186046,86,41,45,48.0,52.0
22.681818181818183,110,41,69,37.0,63.0
13.759036144578314,83,42,41,51.0,49.0
11.875,48,24,24,50.0,50.0
15.05,20,11,9,55.0,45.0
9.833333333333334,36,21,15,58.0,42.0
9.588235294117647,17,6,11,35.0,65.0
28.733333333333334,15,5,10,33.0,67.0
5.75,4,1,3,25.0,75.0
13.333333333333334,3,2,1,67.0,33.0
240.5,2,0,2,0.0,100.0
8.0,1,1,0,100.0,0.0
9.4,5,1,4,20.0,80.0
5.7272727272727275,11,4,7,36.0,64.0
13.428571428571429,21,8,13,38.0,62.0
11.163636363636364,55,30,25,55.0,45.0
13.714285714285714,70,37,33,53.0,47.0
14.45,60,36,24,60.0,40.0
15.204545454545455,44,22,22,50.0,50.0
20.318840579710145,69,31,38,45.0,55.0
18.86764705882353,68,29,39,43.0,57.0
22.395061728395063,81,36,45,44.0,56.0
21.576923076923077,52,27,25,52.0,48.0
15.157142857142857,70,34,36,49.0,51.0
17.681818181818183,88,47,41,53.0,47.0
14.194690265486726,113,41,72,36.0,64.0
32.474747474747474,99,36,63,36.0,64.0
14.625,40,26,14,65.0,35.0
20.352941176470587,34,14,20,41.0,59.0
11.75,36,13,23,36.0,64.0
25.65909090909091,44,20,24,45.0,55.0
24.214285714285715,14,5,9,36.0,64.0
12.6,10,6,4,60.0,40.0
9.5,6,2,4,33.0,67.0
10.0,2,1,1,50.0,50.0
73.5,2,1,1,50.0,50.0
6.666666666666667,3,2,1,67.0,33.0
40.1,10,5,5,50.0,50.0
38.333333333333336,18,7,11,39.0,61.0
36.264150943396224,53,28,25,53.0,47.0
15.211538461538462,52,26,26,50.0,50.0
18.316666666666666,60,27,33,45.0,55.0
18.807692307692307,26,12,14,46.0,54.0
31.254545454545454,55,22,33,40.0,60.0
18.24,50,14,36,28.0,72.0
19.01298701298701,77,26,51,34.0,66.0
27.36082474226804,97,28,69,29.0,71.0
24.171717171717173,99,35,64,35.0,65.0
18.8125,96,50,46,52.0,48.0
21.572916666666668,96,42,54,44.0,56.0
17.533333333333335,75,29,46,39.0,61.0
13.350877192982455,57,28,29,49.0,51.0
18.529411764705884,34,16,18,47.0,53.0
14.891304347826088,46,18,28,39.0,61.0
15.75,40,27,13,68.0,32.0
24.517241379310345,29,10,19,34.0,66.0
18.63157894736842,19,6,13,32.0,68.0
13.857142857142858,14,8,6,57.0,43.0
19.125,8,4,4,50.0,50.0
26.5,4,1,3,25.0,75.0
16.75,4,0,4,0.0,100.0
19.0,3,3,0,100.0,0.0
10.666666666666666,6,3,3,50.0,50.0
16.142857142857142,14,8,6,57.0,43.0
18.0,24,9,15,38.0,62.0
25.794117647058822,34,11,23,32.0,68.0
30.06779661016949,59,19,40,32.0,68.0
39.29113924050633,79,29,50,37.0,63.0
37.1123595505618,89,21,68,24.0,76.0
28.3125,96,29,67,30.0,70.0
34.87755102040816,98,34,64,35.0,65.0
26.988636363636363,88,24,64,27.0,73.0
24.117117117117118,111,30,81,27.0,73.0
23.395604395604394,91,23,68,25.0,75.0
31.1,80,27,53,34.0,66.0
17.8,40,15,25,38.0,62.0
21.970588235294116,34,16,18,47.0,53.0
21.43103448275862,58,19,39,33.0,67.0
24.333333333333332,48,13,35,27.0,73.0
16.36,25,10,15,40.0,60.0
23.842105263157894,19,4,15,21.0,79.0
32.0,12,1,11,8.0,92.0
11.363636363636363,11,5,6,45.0,55.0
26.5,2,1,1,50.0,50.0
14.0,1,1,0,100.0,0.0
13.75,4,2,2,50.0,50.0
7.1,10,3,7,30.0,70.0
30.363636363636363,11,6,5,55.0,45.0
26.0,16,7,9,44.0,56.0
15.692307692307692,26,6,20,23.0,77.0
22.382978723404257,47,13,34,28.0,72.0
17.229508196721312,61,19,42,31.0,69.0
23.56,75,23,52,31.0,69.0
47.84070796460177,113,26,87,23.0,77.0
30.677083333333332,96,30,66,31.0,69.0
25.93846153846154,65,26,39,40.0,60.0
35.02325581395349,86,37,49,43.0,57.0
18.692307692307693,91,31,60,34.0,66.0
29.93548387096774,62,14,48,23.0,77.0
15.466666666666667,30,8,22,27.0,73.0
48.10344827586207,29,4,25,14.0,86.0
23.235294117647058,34,11,23,32.0,68.0
21.65,20,6,14,30.0,70.0
15.0,5,2,3,40.0,60.0
12.857142857142858,7,3,4,43.0,57.0
8.333333333333334,3,1,2,33.0,67.0
53.0,2,2,0,100.0,0.0
9.0,1,0,1,0.0,100.0
9.0,1,1,0,100.0,0.0
9.666666666666666,6,5,1,83.0,17.0
9.6,15,3,12,20.0,80.0
13.066666666666666,45,23,22,51.0,49.0
12.19047619047619,63,31,32,49.0,51.0
16.18918918918919,37,19,18,51.0,49.0
15.323529411764707,34,17,17,50.0,50.0
17.6046511627907,43,21,22,49.0,51.0
21.041666666666668,72,31,41,43.0,57.0
16.419354838709676,62,23,39,37.0,63.0
24.62686567164179,67,28,39,42.0,58.0
23.16883116883117,77,30,47,39.0,61.0
16.568627450980394,102,48,54,47.0,53.0
21.28205128205128,117,44,73,38.0,62.0
13.644444444444444,90,44,46,49.0,51.0
21.121951219512194,41,22,19,54.0,46.0
9.64,25,15,10,60.0,40.0
11.91891891891892,37,18,19,49.0,51.0
12.904761904761905,21,13,8,62.0,38.0
10.0,10,3,7,30.0,70.0
41.5,6,2,4,33.0,67.0
409.6,5,1,4,20.0,80.0
12.2,5,1,4,20.0,80.0
9.666666666666666,9,5,4,56.0,44.0
12.666666666666666,15,6,9,40.0,60.0
11.959183673469388,49,23,26,47.0,53.0
10.788732394366198,71,31,40,44.0,56.0
36.31818181818182,66,36,30,55.0,45.0
16.5,30,17,13,57.0,43.0
12.8125,48,25,23,52.0,48.0
13.551020408163266,49,24,25,49.0,51.0
18.45,60,35,25,58.0,42.0
22.70909090909091,55,30,25,55.0,45.0
13.584615384615384,65,34,31,52.0,48.0
17.07070707070707,99,40,59,40.0,60.0
14.73913043478261,92,42,50,46.0,54.0
13.636363636363637,44,19,25,43.0,57.0
15.862068965517242,29,19,10,66.0,34.0
13.793103448275861,29,13,16,45.0,55.0
9.125,24,11,13,46.0,54.0
20.75,16,10,6,62.0,38.0
13.538461538461538,13,7,6,54.0,46.0
10.0,5,2,3,40.0,60.0
10.0,2,1,1,50.0,50.0
5.0,1,1,0,100.0,0.0
6.75,4,2,2,50.0,50.0
10.875,8,2,6,25.0,75.0
8.928571428571429,14,4,10,29.0,71.0
10.408163265306122,49,28,21,57.0,43.0
13.171875,64,38,26,59.0,41.0
11.705882352941176,51,25,26,49.0,51.0
16.90909090909091,33,23,10,70.0,30.0
16.30188679245283,53,22,31,42.0,58.0
14.125,56,22,34,39.0,61.0
15.10909090909091,55,28,27,51.0,49.0
13.64864864864865,37,14,23,38.0,62.0
27.857142857142858,63,40,23,63.0,37.0
26.228571428571428,70,42,28,60.0,40.0
26.912280701754387,114,51,63,45.0,55.0
14.310344827586206,58,27,31,47.0,53.0
19.40740740740741,27,16,11,59.0,41.0
15.5,38,14,24,37.0,63.0
12.3125,32,19,13,59.0,41.0
16.523809523809526,21,9,12,43.0,57.0
17.176470588235293,17,7,10,41.0,59.0
121.125,8,6,2,75.0,25.0
5.333333333333333,3,2,1,67.0,33.0
8.2,5,4,1,80.0,20.0
23.0,2,2,0,100.0,0.0
12.833333333333334,6,4,2,67.0,33.0
10.166666666666666,12,7,5,58.0,42.0
7.9,10,4,6,40.0,60.0
23.29787234042553,47,29,18,62.0,38.0
15.44927536231884,69,30,39,43.0,57.0
11.169491525423728,59,31,28,53.0,47.0
22.125,32,15,17,47.0,53.0
13.447368421052632,38,13,25,34.0,66.0
17.833333333333332,18,11,7,61.0,39.0
12.921052631578947,38,12,26,32.0,68.0
10.185185185185185,27,18,9,67.0,33.0
10.76,25,13,12,52.0,48.0
12.272727272727273,33,13,20,39.0,61.0
27.677966101694917,59,34,25,58.0,42.0
13.514285714285714,35,23,12,66.0,34.0
51.391304347826086,23,10,13,43.0,57.0
13.333333333333334,12,5,7,42.0,58.0
8.615384615384615,13,8,5,62.0,38.0
18.333333333333332,15,4,11,27.0,73.0
11.0,7,1,6,14.0,86.0
13.333333333333334,6,3,3,50.0,50.0
46.0,1,0,1,0.0,100.0
39.0,2,1,1,50.0,50.0
9.0,1,0,1,0.0,100.0
19.285714285714285,7,3,4,43.0,57.0
10.333333333333334,3,1,2,33.0,67.0
41.42857142857143,14,6,8,43.0,57.0
15.09375,32,18,14,56.0,44.0
17.67241379310345,58,23,35,40.0,60.0
12.53125,32,19,13,59.0,41.0
90.95652173913044,23,11,12,48.0,52.0
15.297297297297296,37,19,18,51.0,49.0
18.175,40,15,25,38.0,62.0
20.928571428571427,42,17,25,40.0,60.0
14.375,48,29,19,60.0,40.0
16.783333333333335,60,38,22,63.0,37.0
12.311475409836065,61,33,28,54.0,46.0
13.292307692307693,65,28,37,43.0,57.0
11.307692307692308,26,14,12,54.0,46.0
10.625,24,13,11,54.0,46.0
12.11111111111111,18,8,10,44.0,56.0
5.285714285714286,7,4,3,57.0,43.0
23.666666666666668,9,7,2,78.0,22.0
25.0,13,4,9,31.0,69.0
10.4,5,4,1,80.0,20.0
12.714285714285714,7,4,3,57.0,43.0
14.0,7,5,2,71.0,29.0
13.75,4,4,0,100.0,0.0
16.666666666666668,3,1,2,33.0,67.0
31.285714285714285,7,6,1,86.0,14.0
20.5,10,1,9,10.0,90.0
13.0,11,7,4,64.0,36.0
17.448275862068964,29,18,11,62.0,38.0
33.76315789473684,38,11,27,29.0,71.0
32.2,45,10,35,22.0,78.0
17.442622950819672,61,19,42,31.0,69.0
27.425531914893618,94,30,64,32.0,68.0
28.8,80,21,59,26.0,74.0
19.135135135135137,74,30,44,41.0,59.0
13.173913043478262,23,9,14,39.0,61.0
18.272727272727273,22,12,10,55.0,45.0
8.428571428571429,14,11,3,79.0,21.0
12.875,24,11,13,46.0,54.0
9.9,10,3,7,30.0,70.0
16.142857142857142,7,5,2,71.0,29.0
32.666666666666664,6,2,4,33.0,67.0
18.2,5,4,1,80.0,20.0
11.0,3,2,1,67.0,33.0
12.0,5,3,2,60.0,40.0
15.25,8,5,3,62.0,38.0
341.75,4,2,2,50.0,50.0
26.5,2,2,0,100.0,0.0
40.0,3,3,0,100.0,0.0
6.0,3,0,3,0.0,100.0
8.4,5,3,2,60.0,40.0
6.8,5,2,3,40.0,60.0
31.416666666666668,12,3,9,25.0,75.0
14.185185185185185,27,7,20,26.0,74.0
23.785714285714285,42,9,33,21.0,79.0
16.333333333333332,57,28,29,49.0,51.0
24.75,48,13,35,27.0,73.0
19.40740740740741,27,8,19,30.0,70.0
13.5,34,13,21,38.0,62.0
23.12,25,11,14,44.0,56.0
18.10810810810811,37,18,19,49.0,51.0
39.34615384615385,26,15,11,58.0,42.0
9.0,21,3,18,14.0,86.0
10.076923076923077,13,8,5,62.0,38.0
15.6,15,8,7,53.0,47.0
19.307692307692307,13,6,7,46.0,54.0
26.46153846153846,13,6,7,46.0,54.0
10.333333333333334,6,4,2,67.0,33.0
5.428571428571429,7,4,3,57.0,43.0
45.0,2,0,2,0.0,100.0
33.666666666666664,3,2,1,67.0,33.0
223.33333333333334,3,0,3,0.0,100.0
5.833333333333333,6,4,2,67.0,33.0
11.125,8,5,3,62.0,38.0
9.5,8,5,3,62.0,38.0
8.756756756756756,37,20,17,54.0,46.0
12.862068965517242,58,31,27,53.0,47.0
30.11627906976744,43,19,24,44.0,56.0
12.935483870967742,31,15,16,48.0,52.0
9.971428571428572,35,17,18,49.0,51.0
20.195121951219512,41,20,21,49.0,51.0
15.045454545454545,44,20,24,45.0,55.0
21.62857142857143,35,16,19,46.0,54.0
16.285714285714285,28,17,11,61.0,39.0
11.35483870967742,31,15,16,48.0,52.0
14.85,80,38,42,48.0,52.0
12.203389830508474,59,26,33,44.0,56.0
15.232558139534884,43,28,15,65.0,35.0
36.65384615384615,26,14,12,54.0,46.0
10.38888888888889,18,11,7,61.0,39.0
23.0,8,4,4,50.0,50.0
12.125,8,6,2,75.0,25.0
15.0,1,1,0,100.0,0.0
16.142857142857142,7,3,4,43.0,57.0
5.0,1,1,0,100.0,0.0
13.0,2,2,0,100.0,0.0
21.166666666666668,6,3,3,50.0,50.0
7.625,8,6,2,75.0,25.0
9.76,25,12,13,48.0,52.0
14.170731707317072,41,20,21,49.0,51.0
12.314285714285715,70,36,34,51.0,49.0
9.868421052631579,38,24,14,63.0,37.0
10.066666666666666,30,10,20,33.0,67.0
14.23076923076923,52,26,26,50.0,50.0
32.19444444444444,36,15,21,42.0,58.0
19.058823529411764,34,17,17,50.0,50.0
13.846153846153847,39,22,17,56.0,44.0
17.897058823529413,68,31,37,46.0,54.0
12.3,60,37,23,62.0,38.0
12.914634146341463,82,38,44,46.0,54.0
14.68421052631579,76,50,26,66.0,34.0
13.551724137931034,29,11,18,38.0,62.0
16.405405405405407,37,24,13,65.0,35.0
8.782608695652174,23,12,11,52.0,48.0
13.941176470588236,17,9,8,53.0,47.0
17.5,8,5,3,62.0,38.0
9.11111111111111,9,4,5,44.0,56.0
15.0,1,1,0,100.0,0.0
17.0,1,0,1,0.0,100.0
20.0,5,2,3,40.0,60.0
10.222222222222221,9,4,5,44.0,56.0
8.157894736842104,19,5,14,26.0,74.0
25.325,40,21,19,52.0,48.0
12.016129032258064,62,31,31,50.0,50.0
15.476190476190476,42,25,17,60.0,40.0
12.26923076923077,26,17,9,65.0,35.0
12.25,32,18,14,56.0,44.0
15.066666666666666,30,11,19,37.0,63.0
11.96774193548387,31,19,12,61.0,39.0
14.717948717948717,39,20,19,51.0,49.0
12.710526315789474,38,18,20,47.0,53.0
30.833333333333332,60,31,29,52.0,48.0
15.234567901234568,81,37,44,46.0,54.0
54.529411764705884,34,18,16,53.0,47.0
11.586206896551724,29,13,16,45.0,55.0
20.7,20,13,7,65.0,35.0
19.066666666666666,15,5,10,33.0,67.0
7.75,12,7,5,58.0,42.0
36.0,15,3,12,20.0,80.0
6.8,10,7,3,70.0,30.0
21.4,10,5,5,50.0,50.0
14.428571428571429,7,1,6,14.0,86.0
84.5,2,1,1,50.0,50.0
7.0,5,1,4,20.0,80.0
10.266666666666667,15,8,7,53.0,47.0
8.0,13,8,5,62.0,38.0
15.137931034482758,29,14,15,48.0,52.0
12.253731343283581,67,32,35,48.0,52.0
25.89830508474576,59,36,23,61.0,39.0
19.095238095238095,42,17,25,40.0,60.0
14.76086956521739,46,21,25,46.0,54.0
15.5,44,23,21,52.0,48.0
10.229508196721312,61,28,33,46.0,54.0
17.169811320754718,53,28,25,53.0,47.0
14.46938775510204,49,23,26,47.0,53.0
27.265822784810126,79,39,40,49.0,51.0
14.069306930693068,101,49,52,49.0,51.0
12.207792207792208,77,35,42,45.0,55.0
23.071428571428573,42,25,17,60.0,40.0
14.097560975609756,41,21,20,51.0,49.0
10.380952380952381,21,7,14,33.0,67.0
15.054054054054054,37,14,23,38.0,62.0
11.521739130434783,23,12,11,52.0,48.0
14.23076923076923,13,6,7,46.0,54.0
124.33333333333333,3,3,0,100.0,0.0
28.75,4,3,1,75.0,25.0
1.0,1,1,0,100.0,0.0
9.2,5,1,4,20.0,80.0
11.777777777777779,9,6,3,67.0,33.0
6.666666666666667,9,5,4,56.0,44.0
16.958333333333332,24,7,17,29.0,71.0
11.238095238095237,63,30,33,48.0,52.0
37.1764705882353,51,27,24,53.0,47.0
36.90909090909091,33,25,8,76.0,24.0
15.294117647058824,51,25,26,49.0,51.0
18.385964912280702,57,23,34,40.0,60.0
13.891304347826088,46,24,22,52.0,48.0
28.761904761904763,42,17,25,40.0,60.0
20.308823529411764,68,26,42,38.0,62.0
15.025641025641026,78,35,43,45.0,55.0
15.0,109,49,60,45.0,55.0
17.651162790697676,43,23,20,53.0,47.0
19.28205128205128,39,13,26,33.0,67.0
20.444444444444443,45,9,36,20.0,80.0
11.757575757575758,33,10,23,30.0,70.0
16.41176470588235,34,19,15,56.0,44.0
28.25,28,14,14,50.0,50.0
19.5,12,2,10,17.0,83.0
19.22222222222222,18,7,11,39.0,61.0
23.333333333333332,3,0,3,0.0,100.0
153.0,5,1,4,20.0,80.0
18.333333333333332,3,2,1,67.0,33.0
13.0,3,3,0,100.0,0.0
23.8,5,3,2,60.0,40.0
8.307692307692308,13,11,2,85.0,15.0
18.70967741935484,31,14,17,45.0,55.0
17.142857142857142,35,15,20,43.0,57.0
15.478260869565217,46,19,27,41.0,59.0
30.58823529411765,51,24,27,47.0,53.0
28.367346938775512,49,14,35,29.0,71.0
18.734177215189874,79,25,54,32.0,68.0
27.647058823529413,51,13,38,25.0,75.0
23.772727272727273,66,21,45,32.0,68.0
14.857142857142858,42,17,25,40.0,60.0
18.970588235294116,34,18,16,53.0,47.0
10.689655172413794,29,17,12,59.0,41.0
30.391304347826086,23,12,11,52.0,48.0
11.8125,16,8,8,50.0,50.0
13.785714285714286,28,6,22,21.0,79.0
25.1,40,12,28,30.0,70.0
13.705882352941176,17,5,12,29.0,71.0
11.555555555555555,9,1,8,11.0,89.0
12.76923076923077,13,2,11,15.0,85.0
50.5,10,6,4,60.0,40.0
12.0,2,2,0,100.0,0.0
8.0,1,1,0,100.0,0.0
120.85714285714286,7,2,5,29.0,71.0
75.25,4,2,2,50.0,50.0
12.4,10,6,4,60.0,40.0
14.423076923076923,26,12,14,46.0,54.0
20.347826086956523,23,6,17,26.0,74.0
24.6046511627907,43,7,36,16.0,84.0
21.28813559322034,59,19,40,32.0,68.0
16.46153846153846,52,22,30,42.0,58.0
25.61038961038961,77,26,51,34.0,66.0
18.375,64,28,36,44.0,56.0
22.863013698630137,73,24,49,33.0,67.0
16.054545454545455,55,29,26,53.0,47.0
15.0,59,29,30,49.0,51.0
9.64864864864865,37,15,22,41.0,59.0
17.0,34,10,24,29.0,71.0
15.0,22,11,11,50.0,50.0
23.352941176470587,17,9,8,53.0,47.0
14.736842105263158,19,7,12,37.0,63.0
18.818181818181817,11,5,6,45.0,55.0
55.09090909090909,11,3,8,27.0,73.0
9.5,4,2,2,50.0,50.0
10.25,4,3,1,75.0,25.0
12.0,1,1,0,100.0,0.0
5.5,2,2,0,100.0,0.0
10.846153846153847,13,8,5,62.0,38.0
23.58823529411765,17,5,12,29.0,71.0
13.568627450980392,51,22,29,43.0,57.0
15.494505494505495,91,40,51,44.0,56.0
22.583333333333332,48,26,22,54.0,46.0
6.142857142857143,21,16,5,76.0,24.0
17.954545454545453,44,31,13,70.0,30.0
13.852941176470589,34,19,15,56.0,44.0
10.897435897435898,39,15,24,38.0,62.0
10.777777777777779,18,15,3,83.0,17.0
19.36842105263158,38,18,20,47.0,53.0
22.21311475409836,61,32,29,52.0,48.0
15.870967741935484,62,27,35,44.0,56.0
11.74,50,28,22,56.0,44.0
10.517241379310345,29,11,18,38.0,62.0
12.0,27,17,10,63.0,37.0
9.03448275862069,29,18,11,62.0,38.0
10.277777777777779,18,8,10,44.0,56.0
27.818181818181817,11,6,5,55.0,45.0
15.5,4,1,3,25.0,75.0
3.0,1,0,1,0.0,100.0
8.0,1,0,1,0.0,100.0
5.666666666666667,3,2,1,67.0,33.0
8.307692307692308,13,8,5,62.0,38.0
21.916666666666668,24,8,16,33.0,67.0
9.708333333333334,48,20,28,42.0,58.0
9.771428571428572,70,33,37,47.0,53.0
10.76595744680851,47,28,19,60.0,40.0
18.64516129032258,31,20,11,65.0,35.0
11.065217391304348,46,28,18,61.0,39.0
16.57777777777778,45,23,22,51.0,49.0
16.5,48,25,23,52.0,48.0
17.80952380952381,42,20,22,48.0,52.0
18.135593220338983,59,29,30,49.0,51.0
13.615384615384615,78,40,38,51.0,49.0
12.014705882352942,68,32,36,47.0,53.0
11.795918367346939,49,24,25,49.0,51.0
13.8,25,16,9,64.0,36.0
8.68421052631579,19,13,6,68.0,32.0
11.818181818181818,22,10,12,45.0,55.0
15.736842105263158,19,7,12,37.0,63.0
12.555555555555555,9,6,3,67.0,33.0
24.0,2,2,0,100.0,0.0
16.0,9,7,2,78.0,22.0
8.5,2,2,0,100.0,0.0
191.5,2,0,2,0.0,100.0
11.1,10,6,4,60.0,40.0
8.714285714285714,14,7,7,50.0,50.0
7.214285714285714,14,6,8,43.0,57.0
10.35,40,21,19,52.0,48.0
11.194444444444445,72,30,42,42.0,58.0
14.82857142857143,35,18,17,51.0,49.0
15.441176470588236,34,13,21,38.0,62.0
11.235294117647058,34,20,14,59.0,41.0
17.291666666666668,48,23,25,48.0,52.0
11.327586206896552,58,29,29,50.0,50.0
13.324324324324325,37,19,18,51.0,49.0
16.341463414634145,41,20,21,49.0,51.0
14.9625,80,46,34,57.0,42.0
15.7625,80,41,39,51.0,49.0
16.895833333333332,48,25,23,52.0,48.0
13.289473684210526,38,19,19,50.0,50.0
12.5625,32,21,11,66.0,34.0
20.347826086956523,23,13,10,57.0,43.0
9.125,16,11,5,69.0,31.0
22.454545454545453,11,5,6,45.0,55.0
20.2,5,2,3,40.0,60.0
10.5,4,1,3,25.0,75.0
81.0,1,0,1,0.0,100.0
32.6,5,4,1,80.0,20.0
8.666666666666666,9,6,3,67.0,33.0
11.631578947368421,19,9,10,47.0,53.0
11.829268292682928,41,20,21,49.0,51.0
16.081967213114755,61,25,36,41.0,59.0
15.686274509803921,51,26,25,51.0,49.0
18.363636363636363,22,11,11,50.0,50.0
13.03225806451613,62,27,35,44.0,56.0
24.85185185185185,54,27,27,50.0,50.0
16.272727272727273,55,19,36,35.0,65.0
17.14814814814815,54,27,27,50.0,50.0
20.596491228070175,57,28,29,49.0,51.0
16.270588235294117,85,47,38,55.0,45.0
25.84931506849315,73,35,38,48.0,52.0
26.545454545454547,66,33,33,50.0,50.0
23.347826086956523,23,14,9,61.0,39.0
11.107142857142858,28,11,17,39.0,61.0
11.074074074074074,27,14,13,52.0,48.0
22.40740740740741,27,16,11,59.0,41.0
11.857142857142858,21,10,11,48.0,52.0
8.666666666666666,3,1,2,33.0,67.0
12.5,2,1,1,50.0,50.0
16.0,1,1,0,100.0,0.0
12.666666666666666,6,3,3,50.0,50.0
9.2,10,5,5,50.0,50.0
11.26086956521739,23,9,14,39.0,61.0
15.977777777777778,45,17,28,38.0,62.0
12.76923076923077,65,28,37,43.0,57.0
17.62162162162162,37,20,17,54.0,46.0
19.676470588235293,34,18,16,53.0,47.0
25.634146341463413,41,24,17,59.0,41.0
16.346938775510203,49,22,27,45.0,55.0
19.535714285714285,56,24,32,43.0,57.0
30.0,70,26,44,37.0,63.0
12.528301886792454,53,19,34,36.0,64.0
13.637931034482758,58,26,32,45.0,55.0
20.596153846153847,52,29,23,56.0,44.0
16.314285714285713,35,14,21,40.0,60.0
33.6,20,11,9,55.0,45.0
8.0,21,12,9,57.0,43.0
32.75,32,13,19,41.0,59.0
34.666666666666664,18,5,13,28.0,72.0
16.318181818181817,22,9,13,41.0,59.0
13.0,11,2,9,18.0,82.0
10.0,11,4,7,36.0,64.0
21.166666666666668,12,5,7,42.0,58.0
16.333333333333332,3,1,2,33.0,67.0
4.75,4,3,1,75.0,25.0
11.7,10,7,3,70.0,30.0
16.125,8,7,1,88.0,12.0
21.0,9,5,4,56.0,44.0
17.77777777777778,18,7,11,39.0,61.0
11.588235294117647,34,14,20,41.0,59.0
18.75,56,14,42,25.0,75.0
33.523809523809526,42,12,30,29.0,71.0
23.454545454545453,55,21,34,38.0,62.0
23.614285714285714,70,20,50,29.0,71.0
23.732558139534884,86,24,62,28.0,72.0
18.578125,64,26,38,41.0,59.0
37.225,40,15,25,38.0,62.0
13.89655172413793,29,11,18,38.0,62.0
13.8,25,12,13,48.0,52.0
18.37037037037037,27,6,21,22.0,78.0
12.258064516129032,31,14,17,45.0,55.0
13.333333333333334,21,14,7,67.0,33.0
10.529411764705882,17,11,6,65.0,35.0
20.866666666666667,15,6,9,40.0,60.0
12.0,9,4,5,44.0,56.0
10.333333333333334,6,0,6,0.0,100.0
29.0,1,1,0,100.0,0.0
7.0,1,1,0,100.0,0.0
7.6,5,2,3,40.0,60.0
10.0,4,1,3,25.0,75.0
12.272727272727273,11,7,4,64.0,36.0
26.952380952380953,21,6,15,29.0,71.0
24.22222222222222,18,4,14,22.0,78.0
34.0,30,8,22,27.0,73.0
56.10909090909091,55,18,37,33.0,67.0
49.68627450980392,51,16,35,31.0,69.0
22.569620253164558,79,32,47,41.0,59.0
33.16494845360825,97,25,72,26.0,74.0
44.38775510204081,49,20,29,41.0,59.0
19.61111111111111,72,24,48,33.0,67.0
12.225,40,24,16,60.0,40.0
13.363636363636363,33,10,23,30.0,70.0
22.25925925925926,27,15,12,56.0,44.0
22.68,25,12,13,48.0,52.0
10.615384615384615,26,18,8,69.0,31.0
14.8,20,10,10,50.0,50.0
13.066666666666666,15,6,9,40.0,60.0
13.5,10,5,5,50.0,50.0
19.0,3,1,2,33.0,67.0
14.0,2,2,0,100.0,0.0
9.0,4,2,2,50.0,50.0
10.428571428571429,7,7,0,100.0,0.0
14.214285714285714,14,4,10,29.0,71.0
11.384615384615385,39,12,27,31.0,69.0
16.05263157894737,57,33,24,58.0,42.0
10.555555555555555,27,10,17,37.0,63.0
21.724137931034484,29,12,17,41.0,59.0
47.19512195121951,41,16,25,39.0,61.0
17.130434782608695,46,14,32,30.0,70.0
18.155555555555555,45,18,27,40.0,60.0
20.836363636363636,55,24,31,44.0,56.0
18.50943396226415,53,23,30,43.0,57.0
18.454545454545453,44,18,26,41.0,59.0
32.21818181818182,55,28,27,51.0,49.0
14.91891891891892,37,25,12,68.0,32.0
121.15,20,10,10,50.0,50.0
12.347826086956522,23,15,8,65.0,35.0
7.888888888888889,9,5,4,56.0,44.0
13.3125,16,7,9,44.0,56.0
9.0,6,4,2,67.0,33.0
10.166666666666666,6,4,2,67.0,33.0
11.333333333333334,3,3,0,100.0,0.0
42.333333333333336,3,3,0,100.0,0.0
5.0,3,1,2,33.0,67.0
9.428571428571429,7,4,3,57.0,43.0
9.3125,16,3,13,19.0,81.0
12.277777777777779,36,13,23,36.0,64.0
11.934426229508198,61,33,28,54.0,46.0
13.305555555555555,36,18,18,50.0,50.0
44.851851851851855,27,16,11,59.0,41.0
10.454545454545455,44,22,22,50.0,50.0
19.142857142857142,35,15,20,43.0,57.0
20.25,32,20,12,62.0,38.0
13.26923076923077,26,14,12,54.0,46.0
13.866666666666667,60,42,18,70.0,30.0
22.75,52,28,24,54.0,46.0
10.582278481012658,79,32,47,41.0,59.0
11.684931506849315,73,36,37,49.0,51.0
18.636363636363637,22,11,11,50.0,50.0
7.62962962962963,27,20,7,74.0,26.0
14.482758620689655,29,11,18,38.0,62.0
9.083333333333334,12,5,7,42.0,58.0
27.166666666666668,6,3,3,50.0,50.0
7.666666666666667,3,2,1,67.0,33.0
10.0,1,0,1,0.0,100.0
10.0,2,1,1,50.0,50.0
12.125,8,6,2,75.0,25.0
7.857142857142857,7,3,4,43.0,57.0
12.0625,16,8,8,50.0,50.0
9.380952380952381,42,22,20,52.0,48.0
19.443037974683545,79,45,34,57.0,43.0
10.2,30,17,13,57.0,43.0
14.256410256410257,39,20,19,51.0,49.0
12.909090909090908,33,20,13,61.0,39.0
12.91304347826087,46,24,22,52.0,48.0
10.116279069767442,43,27,16,63.0,37.0
12.51063829787234,47,25,22,53.0,47.0
14.461538461538462,39,21,18,54.0,46.0
11.52,50,31,19,62.0,38.0
45.65060240963855,83,40,43,48.0,52.0
32.83606557377049,61,26,35,43.0,57.0
11.606060606060606,33,15,18,45.0,55.0
14.5,20,15,5,75.0,25.0
16.85,20,13,7,65.0,35.0
6.928571428571429,14,9,5,64.0,36.0
25.933333333333334,15,5,10,33.0,67.0
12.4,5,4,1,80.0,20.0
11.0,2,0,2,0.0,100.0
224.0,1,1,0,100.0,0.0
6.0,2,2,0,100.0,0.0
26.75,4,3,1,75.0,25.0
7.8,10,6,4,60.0,40.0
24.555555555555557,18,7,11,39.0,61.0
10.959183673469388,49,23,26,47.0,53.0
12.487179487179487,78,43,35,55.0,45.0
47.17391304347826,46,28,18,61.0,39.0
14.774193548387096,31,18,13,58.0,42.0
16.774193548387096,62,28,34,45.0,55.0
17.466666666666665,45,22,23,49.0,51.0
18.173076923076923,52,21,31,40.0,60.0
13.8,50,21,29,42.0,58.0
18.737704918032787,61,27,34,44.0,56.0
16.095890410958905,73,29,44,40.0,60.0
12.094736842105263,95,46,49,48.0,52.0
12.05,60,38,22,63.0,37.0
10.821428571428571,28,17,11,61.0,39.0
15.8,35,15,20,43.0,57.0
16.08823529411765,34,17,17,50.0,50.0
46.73684210526316,19,14,5,74.0,26.0
25.666666666666668,12,6,6,50.0,50.0
19.916666666666668,12,9,3,75.0,25.0
29.6,5,2,3,40.0,60.0
10.6,5,4,1,80.0,20.0
365.6666666666667,3,3,0,100.0,0.0
21.4,5,4,1,80.0,20.0
20.307692307692307,13,5,8,38.0,62.0
13.16,25,8,17,32.0,68.0
19.424242424242426,33,13,20,39.0,61.0
13.231884057971014,69,29,40,42.0,58.0
10.74,50,28,22,56.0,44.0
10.214285714285714,28,18,10,64.0,36.0
22.58,50,25,25,50.0,50.0
28.8125,32,14,18,44.0,56.0
33.640625,64,33,31,52.0,48.0
20.07843137254902,51,27,24,53.0,47.0
13.487804878048781,41,22,19,54.0,46.0
19.383333333333333,60,23,37,38.0,62.0
13.328125,64,25,39,39.0,61.0
12.666666666666666,36,17,19,47.0,53.0
12.075,40,25,15,62.0,38.0
21.526315789473685,38,21,17,55.0,45.0
14.857142857142858,21,12,9,57.0,43.0
16.444444444444443,27,12,15,44.0,56.0
23.96153846153846,26,13,13,50.0,50.0
16.9375,16,5,11,31.0,69.0
9.166666666666666,6,3,3,50.0,50.0
9.666666666666666,3,1,2,33.0,67.0
10.0,1,1,0,100.0,0.0
10.0,4,2,2,50.0,50.0
15.5,4,3,1,75.0,25.0
5.777777777777778,9,6,3,67.0,33.0
14.4,5,3,2,60.0,40.0
14.2,15,4,11,27.0,73.0
24.1875,32,14,18,44.0,56.0
18.058823529411764,34,11,23,32.0,68.0
18.833333333333332,48,23,25,48.0,52.0
22.48936170212766,47,14,33,30.0,70.0
28.49019607843137,51,28,23,55.0,45.0
27.49122807017544,57,26,31,46.0,54.0
37.53846153846154,65,26,39,40.0,60.0
14.862068965517242,58,34,24,59.0,41.0
20.464285714285715,28,16,12,57.0,43.0
14.666666666666666,18,12,6,67.0,33.0
6.944444444444445,18,6,12,33.0,67.0
17.130434782608695,23,15,8,65.0,35.0
9.714285714285714,21,9,12,43.0,57.0
29.633333333333333,30,16,14,53.0,47.0
94.875,24,15,9,62.0,38.0
14.666666666666666,6,3,3,50.0,50.0
28.307692307692307,13,7,6,54.0,46.0
345.6666666666667,6,3,3,50.0,50.0
31.5,2,1,1,50.0,50.0
7.0,5,1,4,20.0,80.0
12.727272727272727,11,6,5,55.0,45.0
6.857142857142857,7,4,3,57.0,43.0
20.357142857142858,14,3,11,21.0,79.0
11.521739130434783,23,10,13,43.0,57.0
61.644444444444446,45,19,26,42.0,58.0
18.32,50,17,33,34.0,66.0
27.863636363636363,44,7,37,16.0,84.0
30.09090909090909,55,21,34,38.0,62.0
32.582089552238806,67,20,47,30.0,70.0
21.65909090909091,44,22,22,50.0,50.0
21.73170731707317,41,11,30,27.0,73.0
10.733333333333333,30,19,11,63.0,37.0
18.85,20,13,7,65.0,35.0
11.866666666666667,15,10,5,67.0,33.0
21.444444444444443,18,8,10,44.0,56.0
14.0,12,7,5,58.0,42.0
14.5,14,3,11,21.0,79.0
7.888888888888889,9,1,8,11.0,89.0
25.142857142857142,7,5,2,71.0,29.0
99.25,4,3,1,75.0,25.0
12.0,1,0,1,0.0,100.0
12.25,4,3,1,75.0,25.0
9.625,8,5,3,62.0,38.0
9.461538461538462,13,5,8,38.0,62.0
8.777777777777779,45,17,28,38.0,62.0
11.411764705882353,68,33,35,49.0,51.0
11.707317073170731,41,19,22,46.0,54.0
23.29032258064516,31,13,18,42.0,58.0
45.93478260869565,46,20,26,43.0,57.0
61.2,45,18,27,40.0,60.0
24.574468085106382,47,20,27,43.0,57.0
16.022727272727273,44,17,27,39.0,61.0
15.081632653061224,49,20,29,41.0,59.0
28.333333333333332,69,38,31,55.0,45.0
10.821428571428571,56,23,33,41.0,59.0
8.083333333333334,48,27,21,56.0,44.0
14.75,36,17,19,47.0,53.0
10.0,19,8,11,42.0,58.0
8.619047619047619,21,14,7,67.0,33.0
17.80952380952381,21,6,15,29.0,71.0
8.545454545454545,11,4,7,36.0,64.0
9.142857142857142,7,6,1,86.0,14.0
15.0,2,0,2,0.0,100.0
11.666666666666666,3,3,0,100.0,0.0
6.0,2,2,0,100.0,0.0
10.75,4,1,3,25.0,75.0
11.6,10,6,4,60.0,40.0
11.928571428571429,14,4,10,29.0,71.0
19.934782608695652,46,26,20,57.0,43.0
9.735294117647058,68,33,35,49.0,51.0
10.35,40,23,17,57.0,42.0
21.153846153846153,39,15,24,38.0,62.0
20.625,56,26,30,46.0,54.0
14.263157894736842,57,24,33,42.0,58.0
15.384615384615385,65,25,40,38.0,62.0
21.924242424242426,66,25,41,38.0,62.0
15.704918032786885,61,29,32,48.0,52.0
14.554054054054054,74,37,37,50.0,50.0
11.682926829268293,82,40,42,49.0,51.0
13.20754716981132,53,26,27,49.0,51.0
8.194444444444445,36,15,21,42.0,58.0
10.054054054054054,37,17,20,46.0,54.0
19.59090909090909,22,11,11,50.0,50.0
11.125,8,5,3,62.0,38.0
15.785714285714286,14,7,7,50.0,50.0
13.5,4,1,3,25.0,75.0
4.666666666666667,3,1,2,33.0,67.0
51.8,5,3,2,60.0,40.0
5.75,4,3,1,75.0,25.0
8.0,12,6,6,50.0,50.0
10.307692307692308,13,7,6,54.0,46.0
10.282051282051283,39,17,22,44.0,56.0
11.052631578947368,57,24,33,42.0,58.0
8.461538461538462,26,16,10,62.0,38.0
12.318181818181818,22,13,9,59.0,41.0
11.48,25,12,13,48.0,52.0
11.785714285714286,28,16,12,57.0,43.0
15.0,15,14,1,93.0,7.0
25.333333333333332,27,17,10,63.0,37.0
16.416666666666668,36,15,21,42.0,58.0
10.128205128205128,39,14,25,36.0,64.0
11.962264150943396,53,30,23,57.0,43.0
12.378378378378379,37,17,20,46.0,54.0
21.147058823529413,34,13,21,38.0,62.0
10.805555555555555,36,14,22,39.0,61.0
12.612903225806452,31,18,13,58.0,42.0
13.153846153846153,13,7,6,54.0,46.0
9.4,5,2,3,40.0,60.0
11.5,8,2,6,25.0,75.0
2.0,1,1,0,100.0,0.0
15.5,4,2,2,50.0,50.0
6.75,4,3,1,75.0,25.0
21.0,2,0,2,0.0,100.0
14.0,2,2,0,100.0,0.0
25.666666666666668,3,2,1,67.0,33.0
17.76923076923077,13,8,5,62.0,38.0
34.75,16,8,8,50.0,50.0
34.888888888888886,18,6,12,33.0,67.0
32.9,20,2,18,10.0,90.0
27.076923076923077,13,4,9,31.0,69.0
23.285714285714285,7,3,4,43.0,57.0
20.875,8,5,3,62.0,38.0
15.636363636363637,11,4,7,36.0,64.0
6.888888888888889,9,2,7,22.0,78.0
30.625,8,4,4,50.0,50.0
10.8,10,6,4,60.0,40.0
9.142857142857142,7,6,1,86.0,14.0
22.11111111111111,9,5,4,56.0,44.0
11.75,4,3,1,75.0,25.0
4.333333333333333,3,2,1,67.0,33.0
16.8,5,4,1,80.0,20.0
24.571428571428573,7,4,3,57.0,43.0
20.25,4,1,3,25.0,75.0
11.5,2,1,1,50.0,50.0
8.333333333333334,3,3,0,100.0,0.0
2.0,1,1,0,100.0,0.0
28.0,12,8,4,67.0,33.0
4.6,5,2,3,40.0,60.0
12.0,9,1,8,11.0,89.0
10.846153846153847,13,5,8,38.0,62.0
6.181818181818182,11,6,5,55.0,45.0
16.285714285714285,7,6,1,86.0,14.0
16.25,8,5,3,62.0,38.0
12.866666666666667,15,8,7,53.0,47.0
22.897435897435898,39,16,23,41.0,59.0
22.333333333333332,21,11,10,52.0,48.0
10.80952380952381,21,8,13,38.0,62.0
12.705882352941176,17,10,7,59.0,41.0
6.2,10,2,8,20.0,80.0
23.142857142857142,14,10,4,71.0,29.0
7.25,16,8,8,50.0,50.0
38.785714285714285,14,5,9,36.0,64.0
67.81818181818181,11,3,8,27.0,73.0
22.77777777777778,9,0,9,0.0,100.0
9.6,5,1,4,20.0,80.0
14.625,8,3,5,38.0,62.0
42.0,3,2,1,67.0,33.0
8.666666666666666,3,2,1,67.0,33.0
12.25,4,2,2,50.0,50.0
6.0,5,4,1,80.0,20.0
17.0,8,4,4,50.0,50.0
34.18181818181818,11,5,6,45.0,55.0
20.866666666666667,15,6,9,40.0,60.0
13.882352941176471,17,12,5,71.0,29.0
26.375,32,11,21,34.0,66.0
26.85,40,17,23,42.0,57.0
31.975609756097562,41,14,27,34.0,66.0
31.735294117647058,68,11,57,16.0,84.0
23.8,50,11,39,22.0,78.0
59.095238095238095,42,14,28,33.0,67.0
38.58620689655172,29,8,21,28.0,72.0
16.8,20,15,5,75.0,25.0
13.461538461538462,13,11,2,85.0,15.0
15.583333333333334,24,10,14,42.0,58.0
15.76923076923077,13,8,5,62.0,38.0
80.66666666666667,9,5,4,56.0,44.0
9.75,12,4,8,33.0,67.0
11.142857142857142,7,2,5,29.0,71.0
17.181818181818183,11,5,6,45.0,55.0
13.25,8,4,4,50.0,50.0
38.0,4,2,2,50.0,50.0
39.333333333333336,3,3,0,100.0,0.0
5.666666666666667,3,1,2,33.0,67.0
8.0,3,2,1,67.0,33.0
8.4,10,5,5,50.0,50.0
15.25,20,9,11,45.0,55.0
7.923076923076923,13,4,9,31.0,69.0
21.652173913043477,23,11,12,48.0,52.0
24.46875,32,13,19,41.0,59.0
18.904761904761905,42,14,28,33.0,67.0
22.135593220338983,59,21,38,36.0,64.0
19.782608695652176,69,20,49,29.0,71.0
16.840579710144926,69,24,45,35.0,65.0
21.0,44,20,24,45.0,55.0
10.289473684210526,38,23,15,61.0,39.0
14.055555555555555,18,6,12,33.0,67.0
11.785714285714286,28,14,14,50.0,50.0
14.75,20,9,11,45.0,55.0
23.5,22,7,15,32.0,68.0
10.727272727272727,11,3,8,27.0,73.0
17.6,10,5,5,50.0,50.0
11.714285714285714,7,5,2,71.0,29.0
12.0,1,1,0,100.0,0.0
9.333333333333334,3,2,1,67.0,33.0
22.75,4,2,2,50.0,50.0
12.666666666666666,6,4,2,67.0,33.0
10.166666666666666,6,5,1,83.0,17.0
19.0,17,6,11,35.0,65.0
10.461538461538462,39,19,20,49.0,51.0
13.245901639344263,61,27,34,44.0,56.0
10.925925925925926,27,11,16,41.0,59.0
11.818181818181818,22,7,15,32.0,68.0
21.2,20,14,6,70.0,30.0
20.066666666666666,30,14,16,47.0,53.0
13.5,36,17,19,47.0,53.0
12.142857142857142,21,10,11,48.0,52.0
9.074074074074074,27,18,9,67.0,33.0
11.529411764705882,34,18,16,53.0,47.0
11.784313725490197,51,22,29,43.0,57.0
9.052631578947368,19,8,11,42.0,58.0
60.84615384615385,13,5,8,38.0,62.0
7.666666666666667,12,8,4,67.0,33.0
14.266666666666667,15,9,6,60.0,40.0
6.75,4,2,2,50.0,50.0
10.833333333333334,6,3,3,50.0,50.0
50.0,4,2,2,50.0,50.0
8.333333333333334,3,3,0,100.0,0.0
11.75,4,3,1,75.0,25.0
8.0,7,5,2,71.0,29.0
10.181818181818182,11,4,7,36.0,64.0
9.075,40,13,27,32.0,68.0
14.98076923076923,52,23,29,44.0,56.0
16.033333333333335,30,14,16,47.0,53.0
26.766666666666666,30,9,21,30.0,70.0
10.758620689655173,29,17,12,59.0,41.0
16.071428571428573,42,21,21,50.0,50.0
16.435897435897434,39,17,22,44.0,56.0
15.487179487179487,39,21,18,54.0,46.0
34.38181818181818,55,20,35,36.0,64.0
9.75,64,22,42,34.0,66.0
61.214285714285715,84,31,53,37.0,63.0
15.8125,48,33,15,69.0,31.0
11.772727272727273,22,15,7,68.0,32.0
13.076923076923077,13,7,6,54.0,46.0
9.863636363636363,22,8,14,36.0,64.0
22.333333333333332,9,4,5,44.0,56.0
9.444444444444445,9,1,8,11.0,89.0
4.5,4,3,1,75.0,25.0
4.0,2,1,1,50.0,50.0
28.0,1,1,0,100.0,0.0
10.5,2,1,1,50.0,50.0
600.4,5,2,3,40.0,60.0
11.25,12,7,5,58.0,42.0
14.384615384615385,13,4,9,31.0,69.0
9.54054054054054,37,18,19,49.0,51.0
11.142857142857142,42,26,16,62.0,38.0
11.61111111111111,18,10,8,56.0,44.0
12.818181818181818,11,8,3,73.0,27.0
14.44,25,14,11,56.0,44.0
14.133333333333333,30,17,13,57.0,43.0
12.5,18,10,8,56.0,44.0
12.588235294117647,17,14,3,82.0,18.0
14.142857142857142,28,14,14,50.0,50.0
10.027027027027026,37,20,17,54.0,46.0
14.827586206896552,58,24,34,41.0,59.0
15.73913043478261,46,18,28,39.0,61.0
8.606060606060606,33,18,15,55.0,45.0
13.615384615384615,26,17,9,65.0,35.0
10.846153846153847,26,14,12,54.0,46.0
15.8,20,12,8,60.0,40.0
15.25,12,6,6,50.0,50.0
16.363636363636363,11,6,5,55.0,45.0
25.0,3,1,2,33.0,67.0
11.25,4,2,2,50.0,50.0
6.0,1,1,0,100.0,0.0
9.777777777777779,9,7,2,78.0,22.0
17.727272727272727,11,5,6,45.0,55.0
9.8125,16,6,10,38.0,62.0
7787.1547619047615,84,38,46,45.0,55.0
13.070422535211268,71,32,39,45.0,55.0
24.365853658536587,41,24,17,59.0,41.0
16.074074074074073,27,11,16,41.0,59.0
15.461538461538462,39,15,24,38.0,62.0
16.391304347826086,46,25,21,54.0,46.0
12.911111111111111,45,23,22,51.0,49.0
16.46,50,24,26,48.0,52.0
21.0,49,18,31,37.0,63.0
15.64179104477612,67,26,41,39.0,61.0
14.777777777777779,99,43,56,43.0,57.0
15.356164383561644,73,47,26,64.0,36.0
13.847826086956522,46,17,29,37.0,63.0
17.40740740740741,27,16,11,59.0,41.0
17.857142857142858,35,14,21,40.0,60.0
14.9,20,9,11,45.0,55.0
24.375,16,11,5,69.0,31.0
29.454545454545453,11,2,9,18.0,82.0
12348.75,8,4,4,50.0,50.0
27.5,2,2,0,100.0,0.0
12.5,2,1,1,50.0,50.0
8.0,3,1,2,33.0,67.0
9.0,5,4,1,80.0,20.0
11.5,12,7,5,58.0,42.0
13.272727272727273,33,15,18,45.0,55.0
12.983333333333333,60,28,32,47.0,53.0
11.545454545454545,33,18,15,55.0,45.0
12.833333333333334,18,11,7,61.0,39.0
21.333333333333332,30,16,14,53.0,47.0
17.382978723404257,47,18,29,38.0,62.0
20.096153846153847,52,21,31,40.0,60.0
34.72093023255814,43,20,23,47.0,53.0
20.8,30,13,17,43.0,57.0
12.428571428571429,14,6,8,43.0,57.0
13.210526315789474,38,15,23,39.0,61.0
16.485714285714284,35,20,15,57.0,43.0
17.40909090909091,22,10,12,45.0,55.0
10.7,10,4,6,40.0,60.0
147.85714285714286,7,3,4,43.0,57.0
9.8,5,3,2,60.0,40.0
12.444444444444445,9,4,5,44.0,56.0
10.833333333333334,6,3,3,50.0,50.0
5.0,4,3,1,75.0,25.0
13.2,5,3,2,60.0,40.0
20.0,2,2,0,100.0,0.0
13.333333333333334,3,1,2,33.0,67.0
22.0,2,2,0,100.0,0.0
28.285714285714285,7,5,2,71.0,29.0
27.25,12,8,4,67.0,33.0
34.19230769230769,26,14,12,54.0,46.0
18.09090909090909,11,4,7,36.0,64.0
13.7,20,5,15,25.0,75.0
11.794117647058824,34,13,21,38.0,62.0
23.514285714285716,35,9,26,26.0,74.0
19.41176470588235,51,22,29,43.0,57.0
22.512820512820515,39,23,16,59.0,41.0
25.727272727272727,55,19,36,35.0,65.0
21.847826086956523,46,24,22,52.0,48.0
9.84,25,14,11,56.0,44.0
14.25,32,15,17,47.0,53.0
8.571428571428571,28,16,12,57.0,43.0
23.08,25,16,9,64.0,36.0
16.285714285714285,28,13,15,46.0,54.0
18.473684210526315,19,10,9,53.0,47.0
19.818181818181817,11,7,4,64.0,36.0
13.818181818181818,11,8,3,73.0,27.0
10.25,4,1,3,25.0,75.0
53.666666666666664,3,2,1,67.0,33.0
6.0,2,1,1,50.0,50.0
13.0,1,1,0,100.0,0.0
5.333333333333333,3,1,2,33.0,67.0
4.0,3,1,2,33.0,67.0
6.2,5,3,2,60.0,40.0
7.666666666666667,15,9,6,60.0,40.0
25.125,8,4,4,50.0,50.0
14.909090909090908,11,5,6,45.0,55.0
20.766666666666666,30,14,16,47.0,53.0
16.642857142857142,42,16,26,38.0,62.0
22.325,40,20,20,50.0,50.0
24.964285714285715,56,18,38,32.0,68.0
30.467741935483872,62,19,43,31.0,69.0
17.672727272727272,55,28,27,51.0,49.0
10.529411764705882,34,16,18,47.0,53.0
11.692307692307692,26,11,15,42.0,58.0
51.8,20,11,9,55.0,45.0
32.588235294117645,17,8,9,47.0,53.0
8.72,25,11,14,44.0,56.0
12.125,16,7,9,44.0,56.0
29.384615384615383,13,8,5,62.0,38.0
20.555555555555557,9,3,6,33.0,67.0
36.666666666666664,3,2,1,67.0,33.0
37.666666666666664,3,3,0,100.0,0.0
4.0,1,1,0,100.0,0.0
9.166666666666666,12,9,3,75.0,25.0
14.9375,16,9,7,56.0,44.0
10.075,40,16,24,40.0,60.0
10.892307692307693,65,35,30,54.0,46.0
21.674418604651162,43,23,20,53.0,47.0
12.565217391304348,23,14,9,61.0,39.0
13.516129032258064,31,23,8,74.0,26.0
10.84375,32,18,14,56.0,44.0
11.232558139534884,43,26,17,60.0,40.0
15.035714285714286,28,19,9,68.0,32.0
21.075,40,21,19,52.0,48.0
11.543478260869565,46,26,20,57.0,43.0
12.090909090909092,55,30,25,55.0,45.0
14.195121951219512,41,22,19,54.0,46.0
15.363636363636363,33,16,17,48.0,52.0
12.515151515151516,33,21,12,64.0,36.0
6.9411764705882355,17,12,5,71.0,29.0
19.5625,16,10,6,62.0,38.0
4.333333333333333,9,4,5,44.0,56.0
62.416666666666664,12,10,2,83.0,17.0
33.75,4,1,3,25.0,75.0
3.0,1,0,1,0.0,100.0
77.0,1,1,0,100.0,0.0
510.5,4,4,0,100.0,0.0
21.714285714285715,14,8,6,57.0,43.0
18.38095238095238,21,11,10,52.0,48.0
9.416666666666666,48,21,27,44.0,56.0
17.134615384615383,52,25,27,48.0,52.0
18.2,35,22,13,63.0,37.0
19.5625,16,6,10,38.0,62.0
14.108108108108109,37,15,22,41.0,59.0
20.91304347826087,46,25,21,54.0,46.0
15.097560975609756,41,28,13,68.0,32.0
18.833333333333332,30,18,12,60.0,40.0
18.5,42,22,20,52.0,48.0
14.04,50,20,30,40.0,60.0
17.17105263157895,76,35,41,46.0,54.0
33.84090909090909,44,28,16,64.0,36.0
15.725,40,24,16,60.0,40.0
16.90909090909091,22,11,11,50.0,50.0
12.545454545454545,11,6,5,55.0,45.0
15.266666666666667,15,10,5,67.0,33.0
30.636363636363637,11,8,3,73.0,27.0
8.571428571428571,7,5,2,71.0,29.0
8.222222222222221,9,7,2,78.0,22.0
12.0,3,2,1,67.0,33.0
11.0,2,1,1,50.0,50.0
9.666666666666666,3,2,1,67.0,33.0
10.642857142857142,14,6,8,43.0,57.0
13.466666666666667,15,7,8,47.0,53.0
10.657894736842104,38,14,24,37.0,63.0
10.061538461538461,65,32,33,49.0,51.0
19.790697674418606,43,21,22,49.0,51.0
25.09090909090909,22,17,5,77.0,23.0
16.434782608695652,46,24,22,52.0,48.0
15.932203389830509,59,24,35,41.0,59.0
15.108108108108109,37,25,12,68.0,32.0
16.74074074074074,27,13,14,48.0,52.0
18.170212765957448,47,18,29,38.0,62.0
13.933333333333334,60,28,32,47.0,53.0
15.180327868852459,61,29,32,48.0,52.0
10.55813953488372,43,24,19,56.0,44.0
13.26923076923077,26,13,13,50.0,50.0
18.2,25,12,13,48.0,52.0
11.0,17,8,9,47.0,53.0
21.928571428571427,14,7,7,50.0,50.0
14.0,10,5,5,50.0,50.0
12.857142857142858,7,4,3,57.0,43.0
3.5,2,0,2,0.0,100.0
77.0,1,1,0,100.0,0.0
58.0,2,2,0,100.0,0.0
14.0,3,3,0,100.0,0.0
18.214285714285715,14,8,6,57.0,43.0
15.347826086956522,23,12,11,52.0,48.0
11.837837837837839,37,19,18,51.0,49.0
53.267857142857146,56,26,30,46.0,54.0
10.210526315789474,38,17,21,45.0,55.0
25.0,21,11,10,52.0,48.0
13.444444444444445,36,11,25,31.0,69.0
14.840909090909092,44,24,20,55.0,45.0
11.228571428571428,35,21,14,60.0,40.0
27.4,20,11,9,55.0,45.0
13.863636363636363,44,17,27,39.0,61.0
13.508474576271187,59,25,34,42.0,58.0
12.266666666666667,60,20,40,33.0,67.0
14.969696969696969,33,17,16,52.0,48.0
14.142857142857142,21,9,12,43.0,57.0
17.944444444444443,18,10,8,56.0,44.0
12.583333333333334,12,4,8,33.0,67.0
7.0588235294117645,17,9,8,53.0,47.0
28.384615384615383,13,9,4,69.0,31.0
10.0,2,1,1,50.0,50.0
5.0,2,0,2,0.0,100.0
16.5,4,2,2,50.0,50.0
10.5,4,2,2,50.0,50.0
9.875,8,3,5,38.0,62.0
11.5,14,7,7,50.0,50.0
11.277777777777779,36,17,19,47.0,53.0
11.338983050847459,59,33,26,56.0,44.0
10.290322580645162,31,12,19,39.0,61.0
20.59090909090909,22,14,8,64.0,36.0
9.804878048780488,41,22,19,54.0,46.0
14.261904761904763,42,17,25,40.0,60.0
42.09090909090909,44,19,25,43.0,57.0
12.590909090909092,44,19,25,43.0,57.0
39.48571428571429,35,17,18,49.0,51.0
16.098039215686274,51,27,24,53.0,47.0
12.552631578947368,38,19,19,50.0,50.0
12.333333333333334,33,10,23,30.0,70.0
15.833333333333334,18,13,5,72.0,28.0
16.55,20,9,11,45.0,55.0
36.06666666666667,15,8,7,53.0,47.0
14.1875,16,5,11,31.0,69.0
14.333333333333334,6,4,2,67.0,33.0
8.833333333333334,6,3,3,50.0,50.0
24.22222222222222,9,3,6,33.0,67.0
4.0,1,1,0,100.0,0.0
21.545454545454547,11,2,9,18.0,82.0
14.5,4,3,1,75.0,25.0
18.0,1,0,1,0.0,100.0
9.666666666666666,9,5,4,56.0,44.0
7.3,10,9,1,90.0,10.0
11.0,13,6,7,46.0,54.0
10.647058823529411,17,8,9,47.0,53.0
8.304347826086957,23,13,10,57.0,43.0
17.153846153846153,13,9,4,69.0,31.0
25.8,25,8,17,32.0,68.0
14.45,40,18,22,45.0,55.0
15.625,40,7,33,18.0,82.0
21.596153846153847,52,14,38,27.0,73.0
9.375,40,14,26,35.0,65.0
11.210526315789474,19,7,12,37.0,63.0
9.25,32,10,22,31.0,69.0
16.82608695652174,23,8,15,35.0,65.0
158.84615384615384,13,10,3,77.0,23.0
15.85,20,11,9,55.0,45.0
12.3,10,4,6,40.0,60.0
12.818181818181818,11,5,6,45.0,55.0
33.5,14,6,8,43.0,57.0
8.625,8,3,5,38.0,62.0
15.666666666666666,3,1,2,33.0,67.0
25.666666666666668,3,2,1,67.0,33.0
4.0,1,1,0,100.0,0.0
6.166666666666667,6,3,3,50.0,50.0
8.428571428571429,7,3,4,43.0,57.0
37.2,5,3,2,60.0,40.0
10.0,11,4,7,36.0,64.0
13.307692307692308,13,5,8,38.0,62.0
32.0,7,4,3,57.0,43.0
14.0,6,6,0,100.0,0.0
11.0,2,1,1,50.0,50.0
7.142857142857143,7,4,3,57.0,43.0
30.2,10,8,2,80.0,20.0
9.375,8,3,5,38.0,62.0
30.857142857142858,7,2,5,29.0,71.0
14.0,9,6,3,67.0,33.0
31.615384615384617,13,8,5,62.0,38.0
14.375,8,4,4,50.0,50.0
19.0,5,2,3,40.0,60.0
15.25,8,5,3,62.0,38.0
10.5,2,0,2,0.0,100.0
12.142857142857142,7,4,3,57.0,43.0
9.0,4,3,1,75.0,25.0
32.5,2,1,1,50.0,50.0
14.0,1,0,1,0.0,100.0
91.8,5,5,0,100.0,0.0
9.666666666666666,9,6,3,67.0,33.0
18.9,20,7,13,35.0,65.0
10.862068965517242,29,11,18,38.0,62.0
13.76923076923077,52,23,29,44.0,56.0
18.363636363636363,33,15,18,45.0,55.0
17.210526315789473,19,12,7,63.0,37.0
13.458333333333334,24,12,12,50.0,50.0
14.045454545454545,22,9,13,41.0,59.0
22.6,30,16,14,53.0,47.0
129.0909090909091,22,11,11,50.0,50.0
46.51724137931034,29,12,17,41.0,59.0
13.533333333333333,45,23,22,51.0,49.0
12.82,50,16,34,32.0,68.0
18.692307692307693,39,19,20,49.0,51.0
16.4,25,10,15,40.0,60.0
31.178571428571427,28,13,15,46.0,54.0
18.666666666666668,12,7,5,58.0,42.0
8.933333333333334,15,9,6,60.0,40.0
25.714285714285715,7,5,2,71.0,29.0
23.0,4,3,1,75.0,25.0
12.0,4,1,3,25.0,75.0
6.5,2,1,1,50.0,50.0
13.5,4,2,2,50.0,50.0
11.727272727272727,22,8,14,36.0,64.0
12.880952380952381,42,18,24,43.0,57.0
16.5625,64,30,34,47.0,53.0
12.137931034482758,29,14,15,48.0,52.0
22.0,18,8,10,44.0,56.0
20.59375,32,14,18,44.0,56.0
10.275,40,12,28,30.0,70.0
10.352941176470589,17,3,14,18.0,82.0
16.0,13,7,6,54.0,46.0
9.384615384615385,13,5,8,38.0,62.0
11.130434782608695,23,15,8,65.0,35.0
12.380952380952381,21,7,14,33.0,67.0
11.571428571428571,14,5,9,36.0,64.0
15.909090909090908,11,7,4,64.0,36.0
6.4,10,5,5,50.0,50.0
9.714285714285714,7,3,4,43.0,57.0
32.8,5,3,2,60.0,40.0
9.785714285714286,14,8,6,57.0,43.0
15.25,4,4,0,100.0,0.0
131.0,2,1,1,50.0,50.0
8.333333333333334,3,2,1,67.0,33.0
34.333333333333336,3,2,1,67.0,33.0
10.083333333333334,12,9,3,75.0,25.0
10.25,16,11,5,69.0,31.0
9.11111111111111,36,12,24,33.0,67.0
17.129032258064516,62,36,26,58.0,42.0
15.829268292682928,41,20,21,49.0,51.0
11.578947368421053,19,7,12,37.0,63.0
15.030303030303031,33,7,26,21.0,79.0
11.571428571428571,35,21,14,60.0,40.0
17.82857142857143,35,13,22,37.0,63.0
13.7,30,17,13,57.0,43.0
25.61764705882353,34,14,20,41.0,59.0
12.10204081632653,49,24,25,49.0,51.0
11.337837837837839,74,25,49,34.0,66.0
14.11111111111111,45,25,20,56.0,44.0
19.666666666666668,18,8,10,44.0,56.0
7.5,12,4,8,33.0,67.0
8.23076923076923,13,5,8,38.0,62.0
14.0,21,11,10,52.0,48.0
34.75,4,3,1,75.0,25.0
6.5,4,3,1,75.0,25.0
3.0,1,0,1,0.0,100.0
28.333333333333332,3,1,2,33.0,67.0
75.0,1,1,0,100.0,0.0
20.166666666666668,6,5,1,83.0,17.0
9.923076923076923,13,6,7,46.0,54.0
8.11111111111111,9,6,3,67.0,33.0
13.0,42,15,27,36.0,64.0
10.125,64,31,33,48.0,52.0
19.54054054054054,37,22,15,59.0,41.0
19.545454545454547,22,5,17,23.0,77.0
21.4,25,8,17,32.0,68.0
9.854166666666666,48,23,25,48.0,52.0
21.609756097560975,41,22,19,54.0,46.0
20.71186440677966,59,33,26,56.0,44.0
13.0,48,20,28,42.0,58.0
13.524590163934427,61,33,28,54.0,46.0
14.095238095238095,63,32,31,51.0,49.0
15.181818181818182,44,22,22,50.0,50.0
10.193548387096774,31,8,23,26.0,74.0
21.375,24,11,13,46.0,54.0
13.071428571428571,14,6,8,43.0,57.0
45.43478260869565,23,11,12,48.0,52.0
16.133333333333333,15,9,6,60.0,40.0
11.6,5,3,2,60.0,40.0
15.88888888888889,9,6,3,67.0,33.0
16.0,2,1,1,50.0,50.0
12.833333333333334,6,4,2,67.0,33.0
48.5,2,1,1,50.0,50.0
10.083333333333334,12,6,6,50.0,50.0
11.421052631578947,19,12,7,63.0,37.0
48.8,40,19,21,48.0,52.0
10.557377049180328,61,28,33,46.0,54.0
13.066666666666666,45,22,23,49.0,51.0
21.962962962962962,27,5,22,19.0,81.0
14.382352941176471,34,14,20,41.0,59.0
13.268292682926829,41,25,16,61.0,39.0
13.920634920634921,63,23,40,37.0,63.0
13.64102564102564,39,20,19,51.0,49.0
19.625,40,18,22,45.0,55.0
22.414634146341463,41,13,28,32.0,68.0
12.8,35,13,22,37.0,63.0
12.375,32,19,13,59.0,41.0
12.421052631578947,19,8,11,42.0,58.0
9.538461538461538,13,5,8,38.0,62.0
27.916666666666668,24,18,6,75.0,25.0
26.55,20,8,12,40.0,60.0
9.714285714285714,7,4,3,57.0,43.0
25.375,8,5,3,62.0,38.0
10.5,10,6,4,60.0,40.0
51.5,4,4,0,100.0,0.0
8.0,2,1,1,50.0,50.0
18.285714285714285,7,2,5,29.0,71.0
8.5,2,2,0,100.0,0.0
77.0,5,2,3,40.0,60.0
31.818181818181817,11,7,4,64.0,36.0
16.11111111111111,18,9,9,50.0,50.0
20.333333333333332,18,7,11,39.0,61.0
26.142857142857142,21,10,11,48.0,52.0
19.394736842105264,38,14,24,37.0,63.0
11.948717948717949,39,21,18,54.0,46.0
22.867924528301888,53,26,27,49.0,51.0
21.31578947368421,38,7,31,18.0,82.0
16.20754716981132,53,19,34,36.0,64.0
21.346938775510203,49,24,25,49.0,51.0
22.43243243243243,37,9,28,24.0,76.0
17.0,31,13,18,42.0,58.0
22.5,28,8,20,29.0,71.0
20.90909090909091,11,6,5,55.0,45.0
22.5,16,8,8,50.0,50.0
12.076923076923077,13,7,6,54.0,46.0
67.6875,16,10,6,62.0,38.0
11.5,4,1,3,25.0,75.0
205.0,2,1,1,50.0,50.0
6.0,1,1,0,100.0,0.0
8.75,4,2,2,50.0,50.0
18.142857142857142,7,2,5,29.0,71.0
6.0,7,2,5,29.0,71.0
30.357142857142858,14,6,8,43.0,57.0
14.818181818181818,11,3,8,27.0,73.0
10.6,20,8,12,40.0,60.0
11.076923076923077,13,4,9,31.0,69.0
14.083333333333334,12,6,6,50.0,50.0
124.75,12,7,5,58.0,42.0
11.9375,16,9,7,56.0,44.0
12.833333333333334,18,8,10,44.0,56.0
10.0,11,7,4,64.0,36.0
21.22222222222222,18,15,3,83.0,17.0
12.73913043478261,23,20,3,87.0,13.0
13.157894736842104,19,11,8,58.0,42.0
19.76923076923077,13,5,8,38.0,62.0
32.888888888888886,9,4,5,44.0,56.0
27.285714285714285,14,5,9,36.0,64.0
17.9,10,7,3,70.0,30.0
26.0,2,0,2,0.0,100.0
31.0,3,2,1,67.0,33.0
223.75,4,4,0,100.0,0.0
77.0,1,1,0,100.0,0.0
4.0,1,1,0,100.0,0.0
7.181818181818182,11,10,1,91.0,9.0
50.0,15,5,10,33.0,67.0
10.473684210526315,38,17,21,45.0,55.0
18.51063829787234,47,19,28,40.0,60.0
13.90625,32,18,14,56.0,44.0
19.413793103448278,29,15,14,52.0,48.0
28.323529411764707,34,13,21,38.0,62.0
16.82051282051282,39,20,19,51.0,49.0
20.57894736842105,38,20,18,53.0,47.0
17.58974358974359,39,24,15,62.0,38.0
20.181818181818183,33,21,12,64.0,36.0
18.59259259259259,27,13,14,48.0,52.0
11.515151515151516,33,15,18,45.0,55.0
17.857142857142858,14,9,5,64.0,36.0
17.76923076923077,13,4,9,31.0,69.0
11.333333333333334,9,5,4,56.0,44.0
15.666666666666666,12,8,4,67.0,33.0
19.0,5,2,3,40.0,60.0
6.333333333333333,3,3,0,100.0,0.0
13.5,4,2,2,50.0,50.0
30.0,2,1,1,50.0,50.0
76.0,2,1,1,50.0,50.0
6.0,2,1,1,50.0,50.0
5.0,2,1,1,50.0,50.0
9.375,8,3,5,38.0,62.0
13.368421052631579,19,7,12,37.0,63.0
8.966666666666667,30,15,15,50.0,50.0
10.689655172413794,29,16,13,55.0,45.0
12.411764705882353,17,10,7,59.0,41.0
17.833333333333332,24,18,6,75.0,25.0
11.771428571428572,35,11,24,31.0,69.0
16.548387096774192,31,17,14,55.0,45.0
15.321428571428571,28,17,11,61.0,39.0
12.727272727272727,44,23,21,52.0,48.0
15.4,30,12,18,40.0,60.0
39.0,34,14,20,41.0,59.0
11.476190476190476,42,11,31,26.0,74.0
9.428571428571429,21,11,10,52.0,48.0
18.444444444444443,18,9,9,50.0,50.0
23.923076923076923,13,4,9,31.0,69.0
14.416666666666666,12,9,3,75.0,25.0
14.75,12,9,3,75.0,25.0
12.166666666666666,6,6,0,100.0,0.0
14.166666666666666,6,2,4,33.0,67.0
16.5,2,1,1,50.0,50.0
7.0,2,1,1,50.0,50.0
5.333333333333333,3,1,2,33.0,67.0
9.0,9,4,5,44.0,56.0
12.166666666666666,18,6,12,33.0,67.0
14.117647058823529,34,17,17,50.0,50.0
11.837209302325581,43,20,23,47.0,53.0
10.642857142857142,28,10,18,36.0,64.0
19.764705882352942,34,11,23,32.0,68.0
12.5,40,20,20,50.0,50.0
11.97872340425532,47,17,30,36.0,64.0
15.45,60,25,35,42.0,58.0
12.105263157894736,38,19,19,50.0,50.0
13.977272727272727,44,23,21,52.0,48.0
18.161290322580644,62,35,27,56.0,44.0
13.391891891891891,74,40,34,54.0,46.0
10.0,43,20,23,47.0,53.0
11.548387096774194,31,18,13,58.0,42.0
22.954545454545453,22,14,8,64.0,36.0
19.555555555555557,27,14,13,52.0,48.0
9.117647058823529,17,8,9,47.0,53.0
12.285714285714286,14,4,10,29.0,71.0
11.25,8,6,2,75.0,25.0
8.1,10,5,5,50.0,50.0
19.428571428571427,7,2,5,29.0,71.0
17.25,4,4,0,100.0,0.0
14.166666666666666,6,2,4,33.0,67.0
8.76923076923077,13,10,3,77.0,23.0
9.1875,16,8,8,50.0,50.0
11.5,24,10,14,42.0,58.0
15.266666666666667,45,22,23,49.0,51.0
9.037037037037036,27,12,15,44.0,56.0
34.0,10,8,2,80.0,20.0
15.619047619047619,21,11,10,52.0,48.0
10.35135135135135,37,15,22,41.0,59.0
23.625,32,16,16,50.0,50.0
9.8,30,15,15,50.0,50.0
15.052631578947368,38,18,20,47.0,53.0
46.1,30,15,15,50.0,50.0
18.372549019607842,51,29,22,57.0,43.0
17.62962962962963,27,18,9,67.0,33.0
10.363636363636363,22,13,9,59.0,41.0
120.5625,16,8,8,50.0,50.0
23.11764705882353,17,12,5,71.0,29.0
21.2,15,7,8,47.0,53.0
15.6875,16,5,11,31.0,69.0
16.8,10,4,6,40.0,60.0
4.75,4,0,4,0.0,100.0
6.5,2,1,1,50.0,50.0
5.0,2,1,1,50.0,50.0
23.5,6,3,3,50.0,50.0
384.22222222222223,9,4,5,44.0,56.0
9.3,10,4,6,40.0,60.0
21.866666666666667,30,14,16,47.0,53.0
17.837209302325583,43,23,20,53.0,47.0
12.541666666666666,24,15,9,62.0,38.0
12.578947368421053,19,7,12,37.0,63.0
25.620689655172413,29,13,16,45.0,55.0
79.48,50,22,28,44.0,56.0
14.391304347826088,46,22,24,48.0,52.0
20.24,50,20,30,40.0,60.0
71.86486486486487,74,23,51,31.0,69.0
15.580645161290322,62,19,43,31.0,69.0
13.083333333333334,48,18,30,38.0,62.0
33.93939393939394,33,15,18,45.0,55.0
14.148148148148149,27,13,14,48.0,52.0
17.8,15,7,8,47.0,53.0
15.166666666666666,24,10,14,42.0,58.0
241.54545454545453,11,4,7,36.0,64.0
20.5,6,4,2,67.0,33.0
93.0,14,1,13,7.0,93.0
10.714285714285714,7,4,3,57.0,43.0
26.75,4,1,3,25.0,75.0
10.5,2,0,2,0.0,100.0
1270.6666666666667,6,3,3,50.0,50.0
496.0,4,2,2,50.0,50.0
12.75,8,4,4,50.0,50.0
4.846153846153846,13,7,6,54.0,46.0
25.85,20,15,5,75.0,25.0
17.38888888888889,18,12,6,67.0,33.0
30.962962962962962,27,15,12,56.0,44.0
11.5625,32,22,10,69.0,31.0
24.347826086956523,23,6,17,26.0,74.0
22.024390243902438,41,25,16,61.0,39.0
13.162162162162161,37,14,23,38.0,62.0
13.357142857142858,42,21,21,50.0,50.0
19.32,25,11,14,44.0,56.0
9.470588235294118,17,9,8,53.0,47.0
10.4,5,4,1,80.0,20.0
344.0,3,2,1,67.0,33.0
14.88888888888889,9,8,1,89.0,11.0
16.5,2,2,0,100.0,0.0
10.0,6,2,4,33.0,67.0
12.142857142857142,7,2,5,29.0,71.0
10.0,1,0,1,0.0,100.0
11.0,2,2,0,100.0,0.0
89.0,3,1,2,33.0,67.0
32.5,2,2,0,100.0,0.0
5.0,1,1,0,100.0,0.0
10.125,8,5,3,62.0,38.0
11.5,6,3,3,50.0,50.0
8.090909090909092,11,4,7,36.0,64.0
31.555555555555557,9,6,3,67.0,33.0
13.923076923076923,13,10,3,77.0,23.0
20.2,20,14,6,70.0,30.0
15.296296296296296,27,17,10,63.0,37.0
28.52,25,16,9,64.0,36.0
15.53125,32,18,14,56.0,44.0
16.25,16,8,8,50.0,50.0
23.0,19,8,11,42.0,58.0
17.526315789473685,19,12,7,63.0,37.0
13.5,14,10,4,71.0,29.0
10.5,8,3,5,38.0,62.0
20.0,1,1,0,100.0,0.0
9.8,10,7,3,70.0,30.0
29.0,4,3,1,75.0,25.0
39.0,11,4,7,36.0,64.0
5.5,6,0,6,0.0,100.0
13.714285714285714,7,1,6,14.0,86.0
8.0,2,0,2,0.0,100.0
8.0,1,0,1,0.0,100.0
63.0,3,3,0,100.0,0.0
6.166666666666667,6,2,4,33.0,67.0
44.75,4,2,2,50.0,50.0
8.916666666666666,12,6,6,50.0,50.0
21.0,9,4,5,44.0,56.0
21.647058823529413,17,9,8,53.0,47.0
22.789473684210527,19,12,7,63.0,37.0
11.958333333333334,24,12,12,50.0,50.0
15.54054054054054,37,18,19,49.0,51.0
91.84848484848484,33,20,13,61.0,39.0
21.2,35,17,18,49.0,51.0
15.4,45,23,22,51.0,49.0
11.068965517241379,29,19,10,66.0,34.0
45.72222222222222,18,10,8,56.0,44.0
20.6,10,8,2,80.0,20.0
30.285714285714285,14,9,5,64.0,36.0
19.444444444444443,9,6,3,67.0,33.0
16.75,8,5,3,62.0,38.0
25.4,5,1,4,20.0,80.0
9.0,4,1,3,25.0,75.0
28.875,8,6,2,75.0,25.0
15.2,5,2,3,40.0,60.0
71.33333333333333,3,2,1,67.0,33.0
10.0,1,1,0,100.0,0.0
116.75,4,3,1,75.0,25.0
7.0,1,0,1,0.0,100.0
8.75,4,4,0,100.0,0.0
45.0,2,2,0,100.0,0.0
10.2,5,3,2,60.0,40.0
5.857142857142857,7,4,3,57.0,43.0
47.25,12,10,2,83.0,17.0
20.571428571428573,14,8,6,57.0,43.0
16.272727272727273,11,9,2,82.0,18.0
52.18181818181818,22,11,11,50.0,50.0
28.0,13,4,9,31.0,69.0
55.42307692307692,26,7,19,27.0,73.0
68.64516129032258,31,12,19,39.0,61.0
32.0,7,3,4,43.0,57.0
102.53333333333333,15,8,7,53.0,47.0
17.68421052631579,19,11,8,58.0,42.0
15.666666666666666,12,4,8,33.0,67.0
18.357142857142858,14,10,4,71.0,29.0
63.0,2,0,2,0.0,100.0
32.833333333333336,6,4,2,67.0,33.0
24.25,4,3,1,75.0,25.0
5.5,2,0,2,0.0,100.0
137.0,1,0,1,0.0,100.0
6.333333333333333,3,2,1,67.0,33.0
18.444444444444443,9,7,2,78.0,22.0
14.0,7,3,4,43.0,57.0
7.583333333333333,12,6,6,50.0,50.0
11.9,20,11,9,55.0,45.0
8.272727272727273,11,5,6,45.0,55.0
23.4,5,3,2,60.0,40.0
74.0909090909091,11,5,6,45.0,55.0
11.863636363636363,22,7,15,32.0,68.0
15.15,20,11,9,55.0,45.0
9.2,15,6,9,40.0,60.0
17.583333333333332,12,5,7,42.0,58.0
18.11111111111111,27,16,11,59.0,41.0
27.833333333333332,18,8,10,44.0,56.0
20.63157894736842,19,13,6,68.0,32.0
10.4,5,4,1,80.0,20.0
13.8,15,8,7,53.0,47.0
31.5,6,5,1,83.0,17.0
19.8,10,7,3,70.0,30.0
23.333333333333332,6,5,1,83.0,17.0
14.5,6,3,3,50.0,50.0
28.666666666666668,3,3,0,100.0,0.0
4.0,1,1,0,100.0,0.0
10.0,1,1,0,100.0,0.0
6.0,4,4,0,100.0,0.0
164.1,10,7,3,70.0,30.0
10.6,5,3,2,60.0,40.0
11.466666666666667,15,8,7,53.0,47.0
71.26086956521739,23,12,11,52.0,48.0
14.0,19,12,7,63.0,37.0
15.782608695652174,23,11,12,48.0,52.0
18.37837837837838,37,11,26,30.0,70.0
19.745454545454546,55,13,42,24.0,76.0
39.0,55,14,41,25.0,75.0
21.488372093023255,43,16,27,37.0,63.0
20.055555555555557,54,17,37,31.0,69.0
14.793103448275861,58,27,31,47.0,53.0
13.36111111111111,36,14,22,39.0,61.0
12.40625,32,24,8,75.0,25.0
12.894736842105264,19,9,10,47.0,53.0
11.68421052631579,19,8,11,42.0,58.0
17.214285714285715,14,6,8,43.0,57.0
33.23076923076923,13,8,5,62.0,38.0
63.642857142857146,14,4,10,29.0,71.0
8.666666666666666,3,2,1,67.0,33.0
11.0,2,2,0,100.0,0.0
3.0,1,1,0,100.0,0.0
19.5,2,1,1,50.0,50.0
10.0,4,2,2,50.0,50.0
10.666666666666666,6,3,3,50.0,50.0
35.75,16,8,8,50.0,50.0
12.148148148148149,27,20,7,74.0,26.0
7.0588235294117645,17,10,7,59.0,41.0
16.25,16,7,9,44.0,56.0
12.432432432432432,37,17,20,46.0,54.0
62.80952380952381,21,10,11,48.0,52.0
12.375,16,11,5,69.0,31.0
18.428571428571427,14,5,9,36.0,64.0
14.333333333333334,12,4,8,33.0,67.0
11.761904761904763,21,9,12,43.0,57.0
10.0,18,8,10,44.0,56.0
11.533333333333333,15,8,7,53.0,47.0
61.6,15,8,7,53.0,47.0
14.9375,16,5,11,31.0,69.0
34.111111111111114,9,2,7,22.0,78.0
249.8,10,5,5,50.0,50.0
9.8,10,3,7,30.0,70.0
6.666666666666667,3,2,1,67.0,33.0
88.6,5,2,3,40.0,60.0
11.0,3,1,2,33.0,67.0
20.5,2,2,0,100.0,0.0
11.0,1,1,0,100.0,0.0
90.2,5,3,2,60.0,40.0
5.0,1,1,0,100.0,0.0
9.23076923076923,13,6,7,46.0,54.0
447.0,10,5,5,50.0,50.0
21.555555555555557,18,9,9,50.0,50.0
33.65217391304348,23,8,15,35.0,65.0
20.678571428571427,28,9,19,32.0,68.0
19.195121951219512,41,22,19,54.0,46.0
25.727272727272727,55,24,31,44.0,56.0
14.21875,32,17,15,53.0,47.0
16.625,24,8,16,33.0,67.0
10.0,10,9,1,90.0,10.0
17.571428571428573,7,5,2,71.0,29.0
17.666666666666668,9,6,3,67.0,33.0
30.0,6,5,1,83.0,17.0
12.75,8,6,2,75.0,25.0
21.0,11,8,3,73.0,27.0
12.75,4,2,2,50.0,50.0
9.0,4,1,3,25.0,75.0
19.0,3,2,1,67.0,33.0
93.25,4,3,1,75.0,25.0
9.0,3,3,0,100.0,0.0
4.25,4,0,4,0.0,100.0
6.166666666666667,6,0,6,0.0,100.0
20.2,5,3,2,60.0,40.0
19.90909090909091,11,6,5,55.0,45.0
21.916666666666668,12,6,6,50.0,50.0
19.0,19,11,8,58.0,42.0
26.390243902439025,41,11,30,27.0,73.0
100.72222222222223,36,10,26,28.0,72.0
17.925925925925927,27,5,22,19.0,81.0
42.75675675675676,37,10,27,27.0,73.0
61.1578947368421,38,14,24,37.0,63.0
16.344827586206897,29,13,16,45.0,55.0
15.055555555555555,18,13,5,72.0,28.0
39.0,10,4,6,40.0,60.0
82.0,4,2,2,50.0,50.0
13.181818181818182,11,5,6,45.0,55.0
19.25,8,4,4,50.0,50.0
14.11111111111111,18,11,7,61.0,39.0
19.5,12,7,5,58.0,42.0
21.333333333333332,6,5,1,83.0,17.0
14.0,1,1,0,100.0,0.0
17.0,1,0,1,0.0,100.0
19.0,1,1,0,100.0,0.0
155.0,3,3,0,100.0,0.0
11.0,10,6,4,60.0,40.0
10.76923076923077,13,5,8,38.0,62.0
10.5,18,7,11,39.0,61.0
20.703703703703702,27,10,17,37.0,63.0
24.448275862068964,29,10,19,34.0,66.0
16.8125,32,13,19,41.0,59.0
21.488372093023255,43,13,30,30.0,70.0
33.333333333333336,48,10,38,21.0,79.0
31.464285714285715,56,21,35,38.0,62.0
49.35820895522388,67,20,47,30.0,70.0
20.658536585365855,41,11,30,27.0,73.0
19.558139534883722,43,16,27,37.0,63.0
13.958333333333334,24,13,11,54.0,46.0
72.85714285714286,14,7,7,50.0,50.0
23.5,8,4,4,50.0,50.0
13.1,10,5,5,50.0,50.0
14.923076923076923,13,6,7,46.0,54.0
56.9375,16,12,4,75.0,25.0
